Unique Line ID,Fiscal Year Ending,County,County Name,Public Safety & Legal Services,Physical Health & Social Services,"Mental Health MR, DD",County Environment & Education,Roads & Transportation,Government Services to Residents,Administration,Nonprogram Current,Debt Service,Capital Projects,Sub-Total Expenditures,Operating Transfers Out,Refunded Debt/Escrow,Total Expenditures,Increase (Decrease) in Reserves,Total Ending Fund Balance,Total Requirements,Primary County Coordinates
2011_52_JOHNSON_EXPEND_SA,2011,52,JOHNSON,20189127,8594931,13266037,3250069,6939002,2152447,6749906,3000,4599650,6809169,72553338,20047971,0,92601309,0,13210946,105812255,POINT (-91.5880849 41.6715511)
2014_2_ADAMS_EXPEND_SA,2014,2,ADAMS,1119300,278111,242559,719175,2799000,244348,785544,32500,543681,80500,6844718,860325,0,7705043,0,2365957,10071000,POINT (-94.6991849 41.02898390000001)
2005_70_MUSCATINE_EXPEND_SA,2005,70,MUSCATINE,5766706,1374848,4654820,750122,4223000,755918,2128719,0,673318,2745000,23072451,505400,,23577851,0,5152394,28730245,POINT (-91.1127562 41.4839221)
2018_36_FREMONT_EXPEND_SA,2018,36,FREMONT,2918415,294022,310726,434807,4137000,512207,1497726,10000,458970,478000,11051873,1379215,0,12431088,0,3788519,16219607,POINT (-95.6046765 40.7455892)
2021_82_SCOTT_EXPEND_SA,2021,82,SCOTT,35590157,6976608,5628347,5402560,7747100,3017786,13463914,0,4867249,12983076,95676797,14563763,0,110240560,0,25115236,135355796,POINT (-90.6232428 41.6370978)
2015_47_IDA_EXPEND_SA,2015,47,IDA,799179,307443,395616,387737,3034651,263280,756191,0,0,1295000,7239097,1106094,0,8345191,0,2123880,10469071,POINT (-95.5134962 42.3868747)
2021_3_ALLAMAKEE_EXPEND_SA,2021,3,ALLAMAKEE,2979902,683355,417540,1260776,7063914,630146,1225019,20750,425304,1500000,16206706,2061960,0,18268666,0,2697821,20966487,POINT (-91.3780923 43.2842838)
2020_17_CERRO GORDO_EXPEND_SA,2020,17,CERRO GORDO,9994629,6162737,2217305,2194796,7320263,1262118,3813036,0,997494,2165000,36127378,7521057,0,43648435,0,17541669,61190104,POINT (-93.2608184 43.081557700000005)
2013_18_CHEROKEE_EXPEND_SA,2013,18,CHEROKEE,1976088,363062,1615906,754971,4074950,508513,1682109,0,0,1560000,12535599,1485000,0,14020599,0,5142975,19163574,POINT (-95.6238055 42.7356226)
2018_51_JEFFERSON_EXPEND_SA,2018,51,JEFFERSON,3261953,873150,576935,746826,4266000,562966,1311464,5000,391987,898000,12894281,1012843,0,13907124,0,4123674,18030798,POINT (-91.9488774 41.0317596)
2022_36_FREMONT_EXPEND_SA,2022,36,FREMONT,3228903,313327,160080,468528,5150000,552156,1788477,10000,719400,5746000,18136871,1399296,0,19536167,0,3785715,23321882,POINT (-95.6046765 40.7455892)
2019_26_DAVIS_EXPEND_SA,2019,26,DAVIS,1788782,408770,537560,470015,4515255,429386,1105164,30539,412190,865000,10562661,914086,0,11476747,0,1984428,13461175,POINT (-92.4097173 40.7476891)
2011_36_FREMONT_EXPEND_SA,2011,36,FREMONT,1908723,299194,1215893,749590,3689100,412134,1307703,2300,145840,341000,10071477,855661,0,10927138,0,2572271,13499409,POINT (-95.6046765 40.7455892)
2015_35_FRANKLIN_EXPEND_SA,2015,35,FRANKLIN,1746426,2453046,498992,890221,4661000,459700,1785725,0,1511400,750000,14756510,1660990,0,16417500,0,5685487,22102987,POINT (-93.262473 42.7325458)
2019_84_SIOUX_EXPEND_SA,2019,84,SIOUX,4665242,1254089,788877,1733619,7411205,1087570,2586529,40000,1316520,4773800,25657451,3128000,0,28785451,0,14247018,43032469,POINT (-96.1778827 43.0826174)
2008_69_MONTGOMERY_EXPEND_SA,2008,69,MONTGOMERY,1587836,731817,993425,291029,2835746,401860,711717,220,64496,778534,8396680,989583,0,9386263,0,1739018,11125281,POINT (-95.1563758 41.03014)
2018_83_SHELBY_EXPEND_SA,2018,83,SHELBY,2467091,577793,684096,445749,6073410,466815,1313174,0,200100,1791900,14020128,3077233,0,17097361,0,2394663,19492024,POINT (-95.31021130000002 41.6850926)
2006_40_HAMILTON_EXPEND_SA,2006,40,HAMILTON,2137520,2039503,2135679,1163653,3960650,596258,1130494,0,1263416,1128323,15555496,2497570,,18053066,0,1825960,19879026,POINT (-93.7068085 42.3837722)
2017_3_ALLAMAKEE_EXPEND_SA,2017,3,ALLAMAKEE,2459078,691847,669033,2301940,6067441,602621,1232445,12000,425000,6687857,21149262,1843443,0,22992705,0,3089531,26082236,POINT (-91.3780923 43.2842838)
2016_80_RINGGOLD_EXPEND_SA,2016,80,RINGGOLD,1523936,871488,562630,303322,3482402,279090,827657,0,489956,450000,8790481,749451,0,9539932,0,3333641,12873573,POINT (-94.2439719 40.7352023)
2012_68_MONROE_EXPEND_SA,2012,68,MONROE,1381348,929279,1053842,340500,2673417,406856,1126291,0,433429,794500,9139462,949712,0,10089174,0,1724811,11813985,POINT (-92.8689877 41.0297826)
2006_3_ALLAMAKEE_EXPEND_SA,2006,3,ALLAMAKEE,1167396,658693,1729663,1089957,3497974,567716,854869,55363,0,900000,10521631,1009050,,11530681,0,2608677,14139358,POINT (-91.3780923 43.2842838)
2019_69_MONTGOMERY_EXPEND_SA,2019,69,MONTGOMERY,3398396,592746,214725,467730,4479415,538188,1374413,0,1263206,4121488,16450307,1010000,0,17460307,0,2450913,19911220,POINT (-95.1563758 41.03014)
2021_50_JASPER_EXPEND_SA,2021,50,JASPER,7682722,2098939,1218400,1725876,8156649,1531645,3664413,22000,1389975,3736000,31226619,6907484,0,38134103,0,8998361,47132464,POINT (-93.053765 41.6860394)
2022_85_STORY_EXPEND_SA,2022,85,STORY,15359113,2867869,1892751,4708301,7659876,2115889,7733922,0,1550920,2886947,46775588,4363809,0,51139397,0,18367577,69506974,POINT (-93.4650448 42.0362415)
2009_84_SIOUX_EXPEND_SA,2009,84,SIOUX,3499008,2117515,2734182,839280,5491400,757531,1946749,42700,531968,3445075,21405408,1767733,0,23173141,0,3736907,26910048,POINT (-96.1778827 43.0826174)
2020_75_PLYMOUTH_EXPEND_SA,2020,75,PLYMOUTH,4449139,406897,657043,1250970,8925000,958001,2873985,0,653625,3995000,24169660,4025000,0,28194660,0,6098992,34293652,POINT (-96.2140431 42.7378346)
2016_17_CERRO GORDO_EXPEND_SA,2016,17,CERRO GORDO,8702324,5356742,2439446,1463369,5694852,1274283,3405156,0,1434389,1490000,31260561,6244339,0,37504900,0,11015204,48520104,POINT (-93.2608184 43.081557700000005)
2008_51_JEFFERSON_EXPEND_SA,2008,51,JEFFERSON,2515579,576700,1298424,571862,2625000,421804,860558,0,161605,335000,9366532,766909,0,10133441,0,2960747,13094188,POINT (-91.9488774 41.0317596)
2022_47_IDA_EXPEND_SA,2022,47,IDA,1182642,304338,267540,1115155,4037503,347794,966693,0,1065536,10308000,19595201,2241583,0,21836784,0,3800012,25636796,POINT (-95.5134962 42.3868747)
2017_50_JASPER_EXPEND_SA,2017,50,JASPER,6306154,2123092,833307,1476004,8782025,1584103,3320675,29000,1673630,935000,27062990,3061770,0,30124760,0,9529115,39653875,POINT (-93.053765 41.6860394)
2013_55_KOSSUTH_EXPEND_SA,2013,55,KOSSUTH,2800742,335562,2257291,906758,6425500,774246,1892051,70193,0,1575000,17037343,2895741,0,19933084,0,7056384,26989468,POINT (-94.2067199 43.20413)
2014_19_CHICKASAW_EXPEND_SA,2014,19,CHICKASAW,1816491,1698439,647211,676514,4828301,457419,1460737,2100,0,224710,11811922,1540831,0,13352753,0,3699318,17052071,POINT (-92.3176637 43.06004140000001)
2008_37_GREENE_EXPEND_SA,2008,37,GREENE,1169427,330192,1226500,1120430,3662750,304071,1170983,0,0,115000,9099353,1222000,0,10321353,0,2250348,12571701,POINT (-94.3968356 42.0362394)
2011_35_FRANKLIN_EXPEND_SA,2011,35,FRANKLIN,1626478,1833346,1398065,1666441,4318644,504686,2162369,0,1126104,15480000,30116133,1629046,0,31745179,0,4247220,35992399,POINT (-93.262473 42.7325458)
2015_42_HARDIN_EXPEND_SA,2015,42,HARDIN,3898732,283150,1194174,917490,5454314,527649,1875409,104682,2486866,687300,17429766,2120901,0,19550667,0,5909102,25459769,POINT (-93.2404025 42.3838803)
2007_52_JOHNSON_EXPEND_SA,2007,52,JOHNSON,13846019,7106101,10968430,2760165,7201871,2038302,6153346,1950,848000,4374578,55298762,11167068,,66465830,0,10875641,77341471,POINT (-91.5880849 41.6715511)
2014_3_ALLAMAKEE_EXPEND_SA,2014,3,ALLAMAKEE,1673242,712448,944617,1175049,5190301,500611,988610,222200,0,1465000,12872078,1582034,0,14454112,0,1842561,16296673,POINT (-91.3780923 43.2842838)
2018_29_DES MOINES_EXPEND_SA,2018,29,DES MOINES,7059297,1953971,2239767,2010702,5862684,1110888,3248301,0,3313531,4524593,31323734,2709551,0,34033285,0,7493352,41526637,POINT (-91.1814707 40.9231829)
2010_24_CRAWFORD_EXPEND_SA,2010,24,CRAWFORD,1792933,2613330,2055415,1107096,7625400,533370,1205016,0,245700,1856000,19034260,1450000,0,20484260,0,4731426,25215686,POINT (-95.3819678 42.0372125)
2015_94_WEBSTER_EXPEND_SA,2015,94,WEBSTER,5288860,4222208,3239329,1843301,8700000,994222,3004080,150000,1024422,2950000,31416422,4174899,0,35591321,0,7144593,42735914,POINT (-94.18178810000002 42.4279662)
2014_72_OSCEOLA_EXPEND_SA,2014,72,OSCEOLA,1215518,256802,370030,480913,2793308,295429,739226,67400,462677,285000,6966303,1285801,0,8252104,0,2679243,10931347,POINT (-95.6236852 43.3785704)
2009_73_PAGE_EXPEND_SA,2009,73,PAGE,1562403,720578,1750000,320442,3386000,421287,912608,5000,103065,545000,9726383,722762,0,10449145,0,2652328,13101473,POINT (-95.1501747 40.7391444)
2007_37_GREENE_EXPEND_SA,2007,37,GREENE,1072528,304369,1238400,777504,3409450,290930,1188552,37000,318410,478000,9115143,923000,,10038143,0,1752264,11790407,POINT (-94.3968356 42.0362394)
2014_51_JEFFERSON_EXPEND_SA,2014,51,JEFFERSON,2781385,991225,607300,669589,3133000,545416,986822,0,293940,564500,10573177,1000000,0,11573177,0,3555850,15129027,POINT (-91.9488774 41.0317596)
2005_1_ADAIR_EXPEND_SA,2005,1,ADAIR,773332,238189,662043,271823,3295708,233533,539761,0,172028,391000,6577417,912831,,7490248,0,2397437,9887685,POINT (-94.4709413 41.3307464)
2016_91_WARREN_EXPEND_SA,2016,91,WARREN,4874830,3334155,1798061,1349331,6405460,963733,2864420,0,61450,2309340,23960780,2941000,0,26901780,0,8216293,35118073,POINT (-93.5613594 41.3343735)
2012_85_STORY_EXPEND_SA,2012,85,STORY,9858348,2109692,10217799,2533670,5402550,1184291,4573426,0,1922643,1867031,39669450,2105000,0,41774450,0,8389637,50164087,POINT (-93.4650448 42.0362415)
2010_61_MADISON_EXPEND_SA,2010,61,MADISON,2101375,896701,1520550,611832,4079967,435536,863133,0,81381,973111,11563586,1335534,0,12899120,0,2929923,15829043,POINT (-94.01556190000001 41.33071420000001)
2011_73_PAGE_EXPEND_SA,2011,73,PAGE,1681411,775047,1937888,365530,3414970,457870,973431,5000,102935,384251,10098333,717948,0,10816281,0,3486476,14302757,POINT (-95.1501747 40.7391444)
2018_9_BREMER_EXPEND_SA,2018,9,BREMER,4237923,1799707,1186675,1591049,5365000,842912,1695739,66626,322310,1417000,18524941,3248850,0,21773791,0,12030292,33804083,POINT (-92.31805480000001 42.7745873)
2005_89_VAN BUREN_EXPEND_SA,2005,89,VAN BUREN,828161,339321,540221,277032,2515630,277021,464929,3500,0,394283,5640098,487441,,6127539,0,1594455,7721994,POINT (-91.9499871 40.7532294)
2020_65_MILLS_EXPEND_SA,2020,65,MILLS,3928911,2290842,276125,1702072,6399078,634914,4480806,0,1340716,1081347,22134811,2601886,0,24736697,0,6139740,30876437,POINT (-95.62132670000001 41.0334523)
2020_70_MUSCATINE_EXPEND_SA,2020,70,MUSCATINE,12179914,1296156,1547850,1557760,7471000,945638,3377859,0,2228386,5165000,35769563,2544710,0,38314273,0,13994699,52308972,POINT (-91.1127562 41.4839221)
2016_22_CLAYTON_EXPEND_SA,2016,22,CLAYTON,2941162,773119,812835,1295555,5269836,705401,1887550,1300,352964,1750500,15790222,1700000,0,17490222,0,4685066,22175288,POINT (-91.34143280000002 42.8447493)
2022_4_APPANOOSE_EXPEND_SA,2022,4,APPANOOSE,2978946,519248,624242,839144,4126420,610127,1085832,0,562323,7549830,18896112,913054,0,19809166,0,6152279,25961445,POINT (-92.8686104 40.7431635)
2009_86_TAMA_EXPEND_SA,2009,86,TAMA,2969634,1368823,2000213,602577,5767957,506319,1365652,10750,0,1517305,16109230,1618472,0,17727702,0,1493319,19221021,POINT (-92.5325425 42.07981170000001)
2008_56_LEE_EXPEND_SA,2008,56,LEE,3872948,3658181,4936309,1312349,3750136,934902,2436746,0,0,1058885,21960456,1060000,0,23020456,0,5305519,28325975,POINT (-91.479264 40.6419764)
2017_13_CALHOUN_EXPEND_SA,2017,13,CALHOUN,2806675,1801601,456906,955963,5364400,677049,1361216,5225,0,1303000,14732035,1713646,0,16445681,0,6513025,22958706,POINT (-94.6404136 42.385184800000005)
2022_68_MONROE_EXPEND_SA,2022,68,MONROE,2382767,875626,320668,506191,3851668,571273,1542328,0,1007000,777895,11835416,1487102,0,13322518,0,3831653,17154171,POINT (-92.8689877 41.0297826)
2009_13_CALHOUN_EXPEND_SA,2009,13,CALHOUN,1353352,3839719,1238670,650097,3724645,493785,1084334,7425,0,660450,13052477,1336815,0,14389292,0,2938457,17327749,POINT (-94.6404136 42.385184800000005)
2014_87_TAYLOR_EXPEND_SA,2014,87,TAYLOR,1152653,1025085,192538,430225,3297000,343719,667490,0,747308,1031919,8887937,771732,0,9659669,0,1990609,11650278,POINT (-94.6964148 40.73743240000001)
2006_72_OSCEOLA_EXPEND_SA,2006,72,OSCEOLA,905498,152717,596500,606003,2000000,301827,598431,0,0,490000,5650976,540842,,6191818,0,2016081,8207899,POINT (-95.6236852 43.3785704)
2017_24_CRAWFORD_EXPEND_SA,2017,24,CRAWFORD,2467339,2606770,683505,1156890,7323176,750775,1558865,0,153242,1118274,17818836,2881500,0,20700336,0,6164253,26864589,POINT (-95.3819678 42.0372125)
2010_29_DES MOINES_EXPEND_SA,2010,29,DES MOINES,6177634,2719388,4722417,2226465,4218376,1028225,3244193,0,680756,2030000,27047454,1708524,0,28755978,0,2325430,31081408,POINT (-91.1814707 40.9231829)
2016_70_MUSCATINE_EXPEND_SA,2016,70,MUSCATINE,9467761,1267849,2565838,1223003,6301000,836277,3016251,0,2316850,5691000,32685829,1654756,0,34340585,0,8851214,43191799,POINT (-91.1127562 41.4839221)
2010_88_UNION_EXPEND_SA,2010,88,UNION,1316777,433052,1560976,521615,3297025,450806,911389,0,810369,4756096,14058105,637873,0,14695978,0,2747337,17443315,POINT (-94.2423792 41.0277304)
2012_70_MUSCATINE_EXPEND_SA,2012,70,MUSCATINE,8209965,1334886,5247687,991908,5375000,861859,2754287,0,4614506,1406000,30796098,1459100,0,32255198,0,3491253,35746451,POINT (-91.1127562 41.4839221)
2015_16_CEDAR_EXPEND_SA,2015,16,CEDAR,3834578,1491082,1107631,1349123,5549305,546527,1677576,5100,0,887000,16447922,2098303,0,18546225,0,2383250,20929475,POINT (-91.1324125 41.7723207)
2021_13_CALHOUN_EXPEND_SA,2021,13,CALHOUN,3357955,1502773,506567,1680389,5558200,509917,1650233,81850,0,4156660,19004544,1792673,0,20797217,0,7754928,28552145,POINT (-94.6404136 42.385184800000005)
2019_21_CLAY_EXPEND_SA,2019,21,CLAY,3260580,733074,178078,1501181,6110976,535766,2327252,0,489800,1450000,16586707,2401902,0,18988609,0,6601431,25590040,POINT (-95.1509194 43.0825804)
2006_17_CERRO GORDO_EXPEND_SA,2006,17,CERRO GORDO,5240076,4188140,5429403,994409,5459027,842986,2051057,50500,673581,1935000,26864179,2365932,,29230111,0,6963738,36193849,POINT (-93.2608184 43.081557700000005)
2011_90_WAPELLO_EXPEND_SA,2011,90,WAPELLO,3468777,1740358,4904521,964484,3807680,584602,2745257,138516,310100,1282000,19946295,1099500,0,21045795,0,7196342,28242137,POINT (-92.4094499 41.03058450000001)
2012_38_GRUNDY_EXPEND_SA,2012,38,GRUNDY,1765442,539263,1251384,1697876,3899302,449843,1842742,0,1294330,1634228,14374410,2244213,0,16618623,0,3893945,20512568,POINT (-92.7914177 42.4018651)
2018_4_APPANOOSE_EXPEND_SA,2018,4,APPANOOSE,2692208,885701,507103,793613,3493000,542085,1104838,0,150092,568754,10737394,735590,0,11472984,0,5987738,17460722,POINT (-92.8686104 40.7431635)
2007_20_CLARKE_EXPEND_SA,2007,20,CLARKE,1452849,939705,1064940,266067,2184800,297241,725966,0,528650,127300,7587518,522842,,8110360,0,3476828,11587188,POINT (-93.78515790000002 41.0290323)
2007_79_POWESHIEK_EXPEND_SA,2007,79,POWESHIEK,2148640,421381,1560780,613441,4559085,624088,1269044,232551,180000,1549000,13158010,1651818,,14809828,0,2624063,17433891,POINT (-92.53146840000001 41.6864422)
2015_79_POWESHIEK_EXPEND_SA,2015,79,POWESHIEK,2973131,432776,1157777,494205,5851040,769505,1448478,185572,847053,892500,15052037,2225353,0,17277390,0,5188843,22466233,POINT (-92.53146840000001 41.6864422)
2020_38_GRUNDY_EXPEND_SA,2020,38,GRUNDY,2153422,549879,736888,968941,5700704,502893,1951546,0,1832578,1801013,16197864,2709492,0,18907356,0,3793366,22700722,POINT (-92.7914177 42.4018651)
2019_58_LOUISA_EXPEND_SA,2019,58,LOUISA,3188530,813064,438004,1142322,4089553,382016,1287033,0,339870,11258342,22938734,1600620,0,24539354,0,3358458,27897812,POINT (-91.2596184 41.2185073)
2021_35_FRANKLIN_EXPEND_SA,2021,35,FRANKLIN,2136297,1631543,394128,1304816,6967000,553109,2362572,0,3441000,677000,19467465,3685479,0,23152944,0,8848011,32000955,POINT (-93.262473 42.7325458)
2015_5_AUDUBON_EXPEND_SA,2015,5,AUDUBON,1429804,595074,197058,488397,3342871,300162,701061,0,341805,753347,8149579,999190,0,9148769,0,3115855,12264624,POINT (-94.9058222 41.6845893)
2019_16_CEDAR_EXPEND_SA,2019,16,CEDAR,4215077,1381519,624631,2062945,6782600,546065,1803516,7000,0,1075000,18498353,2542162,0,21040515,0,4142373,25182888,POINT (-91.1324125 41.7723207)
2019_37_GREENE_EXPEND_SA,2019,37,GREENE,1945560,616660,375490,696323,5906100,396638,1963653,210000,0,241517,12351941,1573150,0,13925091,0,3111798,17036889,POINT (-94.3968356 42.0362394)
2008_12_BUTLER_EXPEND_SA,2008,12,BUTLER,1617230,1410492,1450400,728033,4187000,424379,1256857,7500,38943,1634000,12754834,1253650,0,14008484,0,3030673,17039157,POINT (-92.7901934 42.7315661)
2020_85_STORY_EXPEND_SA,2020,85,STORY,13138790,2668123,1927134,4562290,6382925,1551138,6642224,50000,1672400,4954463,43549487,3500000,0,47049487,0,17810896,64860383,POINT (-93.4650448 42.0362415)
2012_49_JACKSON_EXPEND_SA,2012,49,JACKSON,1765780,381210,2652985,1408083,4485312,557783,1390325,121900,0,211072,12974450,990000,0,13964450,0,3756566,17721016,POINT (-90.5742294 42.1717426)
2015_84_SIOUX_EXPEND_SA,2015,84,SIOUX,4452211,770056,1670537,2113961,5912825,907351,2369172,92000,889239,2305050,21482402,2999458,0,24481860,0,10140187,34622047,POINT (-96.1778827 43.0826174)
2020_60_LYON_EXPEND_SA,2020,60,LYON,3511588,648763,266263,922303,5635000,511906,1233072,194298,632400,3186000,16741593,3765567,0,20507160,0,7384461,27891621,POINT (-96.2102924 43.380497)
2005_6_BENTON_EXPEND_SA,2005,6,BENTON,2409458,713912,1826748,1298021,5355051,660204,1250584,4000,302628,2986254,16806860,3112249,,19919109,0,3958330,23877439,POINT (-92.0656912 42.0801864)
2022_46_HUMBOLDT_EXPEND_SA,2022,46,HUMBOLDT,2568562,409451,455486,892715,4276356,551801,1463912,13000,350513,1530000,12511796,1879085,0,14390881,0,5114072,19504953,POINT (-94.2071868 42.7764686)
2013_82_SCOTT_EXPEND_SA,2013,82,SCOTT,28801440,6107415,16926575,4662956,5780000,2284878,9890135,0,4363865,3989030,82806294,10635264,0,93441558,0,18018105,111459663,POINT (-90.6232428 41.6370978)
2017_18_CHEROKEE_EXPEND_SA,2017,18,CHEROKEE,2316068,389761,465800,974912,5290631,558589,1536598,0,0,3206000,14738359,1950000,0,16688359,0,7501248,24189607,POINT (-95.6238055 42.7356226)
2009_54_KEOKUK_EXPEND_SA,2009,54,KEOKUK,843543,688493,1037696,356150,3457100,345010,1496195,0,0,584000,8808187,1004000,0,9812187,0,3125443,12937630,POINT (-92.1786426 41.336465)
2006_22_CLAYTON_EXPEND_SA,2006,22,CLAYTON,1974014,485043,1517859,940704,5108550,517416,1172696,1300,1244254,2703132,15664968,1190000,,16854968,0,4856097,21711065,POINT (-91.34143280000002 42.8447493)
2007_50_JASPER_EXPEND_SA,2007,50,JASPER,4114673,1874920,4179798,1134192,5382540,828705,2389518,5000,1493905,1213395,22616646,2725562,,25342208,0,3656366,28998574,POINT (-93.053765 41.6860394)
2021_8_BOONE_EXPEND_SA,2021,8,BOONE,4553371,767049,740200,1403925,7061494,745947,2229716,100000,715998,1425000,19742700,3728343,0,23471043,0,3583199,27054242,POINT (-93.931671 42.0365493)
2016_54_KEOKUK_EXPEND_SA,2016,54,KEOKUK,1177927,727404,673625,361591,4631200,407876,1927119,0,0,493000,10399742,1346150,0,11745892,0,2724235,14470127,POINT (-92.1786426 41.336465)
2008_83_SHELBY_EXPEND_SA,2008,83,SHELBY,1644499,423949,1997291,358719,4330550,418272,1046609,0,228609,507473,10955971,1812983,0,12768954,0,2562961,15331915,POINT (-95.31021130000002 41.6850926)
2017_82_SCOTT_EXPEND_SA,2017,82,SCOTT,29723373,6559546,5070706,4845056,6198523,2431520,11039710,0,3866579,9780100,79515113,13042109,0,92557222,0,29972565,122529787,POINT (-90.6232428 41.6370978)
2013_87_TAYLOR_EXPEND_SA,2013,87,TAYLOR,893508,1086472,538588,232395,3127000,317235,654323,0,842529,6002000,13694050,696910,0,14390960,0,2024214,16415174,POINT (-94.6964148 40.73743240000001)
2009_45_HOWARD_EXPEND_SA,2009,45,HOWARD,1131713,466863,1356176,952732,2918553,314131,875257,1000,49940,39387,8105752,861063,0,8966815,0,1751102,10717917,POINT (-92.3171989 43.3567673)
2011_62_MAHASKA_EXPEND_SA,2011,62,MAHASKA,2832419,797842,2698263,946164,4919500,596189,1350576,931500,8490,816500,15897443,1696285,0,17593728,0,7597939,25191667,POINT (-92.6409094 41.3352035)
2010_17_CERRO GORDO_EXPEND_SA,2010,17,CERRO GORDO,7446909,5256545,6457283,1268747,5395611,1016147,2537360,40500,978696,3150000,33547798,4248116,0,37795914,0,8277545,46073459,POINT (-93.2608184 43.081557700000005)
2020_49_JACKSON_EXPEND_SA,2020,49,JACKSON,2808663,478739,596085,2087668,5994249,811240,2223693,0,0,1591979,16592316,1301250,0,17893566,0,5953958,23847524,POINT (-90.5742294 42.1717426)
2011_21_CLAY_EXPEND_SA,2011,21,CLAY,2274204,504762,1779857,1199463,4836791,441425,1817678,0,345000,1450000,14649180,2236494,0,16885674,0,3812740,20698414,POINT (-95.1509194 43.0825804)
2022_10_BUCHANAN_EXPEND_SA,2022,10,BUCHANAN,4576544,1285236,1041534,1382748,8494600,893319,1864221,65300,971838,2671920,23247260,2366412,0,25613672,0,5526293,31139965,POINT (-91.8378392 42.4707777)
2007_72_OSCEOLA_EXPEND_SA,2007,72,OSCEOLA,951347,155443,676400,289689,2100000,209095,647190,0,302938,805114,6137216,550371,,6687587,0,2192420,8880007,POINT (-95.6236852 43.3785704)
2011_84_SIOUX_EXPEND_SA,2011,84,SIOUX,3929249,1476324,2753912,1020443,5846150,789517,2141917,6234750,882965,3529100,28604327,2319258,0,30923585,0,3863221,34786806,POINT (-96.1778827 43.0826174)
2018_19_CHICKASAW_EXPEND_SA,2018,19,CHICKASAW,2177577,1570622,860937,733996,5542849,446580,1593604,0,0,590945,13517110,2143453,0,15660563,0,5040884,20701447,POINT (-92.3176637 43.06004140000001)
2007_5_AUDUBON_EXPEND_SA,2007,5,AUDUBON,942492,550218,804500,482022,2720965,268108,660647,1235,406399,689455,7526041,633423,,8159464,0,2525346,10684810,POINT (-94.9058222 41.6845893)
2011_4_APPANOOSE_EXPEND_SA,2011,4,APPANOOSE,1955640,792907,1268212,1007980,2993000,470988,980643,0,194780,770000,10434150,499940,0,10934090,0,5272369,16206459,POINT (-92.8686104 40.7431635)
2019_52_JOHNSON_EXPEND_SA,2019,52,JOHNSON,25857149,12661567,7397539,5642211,11452927,3045489,10183792,6150,20871322,14732379,111850525,15323711,0,127174236,0,23982997,151157233,POINT (-91.5880849 41.6715511)
2015_52_JOHNSON_EXPEND_SA,2015,52,JOHNSON,22220196,9065574,9723065,4041941,9403108,2304099,8231713,79500,16082017,16545107,97696320,14103015,0,111799335,0,18135646,129934981,POINT (-91.5880849 41.6715511)
2013_70_MUSCATINE_EXPEND_SA,2013,70,MUSCATINE,9630152,1309033,6684700,1106367,5628000,851397,2897760,0,1585000,5560000,35252409,2124000,0,37376409,0,5643690,43020099,POINT (-91.1127562 41.4839221)
2016_85_STORY_EXPEND_SA,2016,85,STORY,10851503,2475098,4711129,3557696,6261175,1794759,5837812,0,1183776,3052100,39725048,3883024,0,43608072,0,12416594,56024666,POINT (-93.4650448 42.0362415)
2020_2_ADAMS_EXPEND_SA,2020,2,ADAMS,1650574,223147,153584,855671,3517843,366628,930643,0,773869,5000,8476959,1154120,0,9631079,0,2616845,12247924,POINT (-94.6991849 41.02898390000001)
2020_13_CALHOUN_EXPEND_SA,2020,13,CALHOUN,3245705,1538213,465909,1259280,5457850,548620,1607841,336000,0,4509000,18968418,1923299,0,20891717,0,5749874,26641591,POINT (-94.6404136 42.385184800000005)
2005_11_BUENA VISTA_EXPEND_SA,2005,11,BUENA VISTA,2088913,1151195,1330451,554582,3461000,481173,1064371,283250,849641,1106700,12371276,1620499,,13991775,0,3586062,17577837,POINT (-95.15114900000002 42.7354936)
2022_23_CLINTON_EXPEND_SA,2022,23,CLINTON,9861897,2205216,1402993,2347653,7854870,1348518,4422921,24000,2750185,2235927,34454180,2103191,0,36557371,0,13886684,50444055,POINT (-90.5319724 41.8980358)
2015_89_VAN BUREN_EXPEND_SA,2015,89,VAN BUREN,1187166,557382,212110,415556,3366000,295597,638552,3200,0,365000,7040563,641178,0,7681741,0,2243127,9924868,POINT (-91.9499871 40.7532294)
2019_41_HANCOCK_EXPEND_SA,2019,41,HANCOCK,2038954,463042,468652,714294,6644093,561772,1343772,34100,0,355000,12623679,2414520,0,15038199,0,4413456,19451655,POINT (-93.7342723 43.0818861)
2021_88_UNION_EXPEND_SA,2021,88,UNION,2098070,501359,495156,646458,3866401,492584,1170608,0,1937683,2325543,13533862,962119,0,14495981,0,3491627,17987608,POINT (-94.2423792 41.0277304)
2021_25_DALLAS_EXPEND_SA,2021,25,DALLAS,14802807,2004189,3281513,2825094,9703774,2317487,2241249,150500,2322916,8455000,48104529,12674529,0,60779058,0,20682338,81461396,POINT (-94.0397374 41.6848862)
2008_89_VAN BUREN_EXPEND_SA,2008,89,VAN BUREN,984033,389824,572752,324269,2293000,284024,574819,3350,0,746500,6172571,476382,0,6648953,0,1598792,8247745,POINT (-91.9499871 40.7532294)
2008_88_UNION_EXPEND_SA,2008,88,UNION,1268408,375968,1389354,410428,2626628,435656,825544,0,649544,503130,8484660,560810,0,9045470,0,1224983,10270453,POINT (-94.2423792 41.0277304)
2005_57_LINN_EXPEND_SA,2005,57,LINN,17989893,13420214,25429567,4876729,10140234,3073734,8489598,17905,1251322,1924761,86613957,5570630,,92184587,0,16333094,108517681,POINT (-91.5989646 42.0789478)
2021_72_OSCEOLA_EXPEND_SA,2021,72,OSCEOLA,1962056,255225,132880,795747,4219766,307566,1213642,169195,353725,56000,9465802,1717162,0,11182964,0,4143653,15326617,POINT (-95.6236852 43.3785704)
2016_49_JACKSON_EXPEND_SA,2016,49,JACKSON,2263997,487782,1188473,1809889,5043303,670154,1846228,0,0,263685,13573511,980000,0,14553511,0,4695068,19248579,POINT (-90.5742294 42.1717426)
2022_74_PALO ALTO_EXPEND_SA,2022,74,PALO ALTO,2488677,410062,368783,1617588,6703314,535874,1363328,0,1854362,617000,15958988,2660557,0,18619545,0,6991390,25610935,POINT (-94.6781371 43.0820643)
2018_24_CRAWFORD_EXPEND_SA,2018,24,CRAWFORD,2601362,2631510,639564,1057156,7562377,728640,1474425,0,156682,1551123,18402839,3219500,0,21622339,0,6548887,28171226,POINT (-95.3819678 42.0372125)
2010_39_GUTHRIE_EXPEND_SA,2010,39,GUTHRIE,1122895,1341936,1490575,1222118,4860891,408618,1135647,0,435000,870000,12887680,1459225,0,14346905,0,2080868,16427773,POINT (-94.501055 41.6837548)
2010_56_LEE_EXPEND_SA,2010,56,LEE,3847663,3966799,4983011,1576504,3910642,931450,2278223,62000,746888,2479954,24783134,1210000,0,25993134,0,5973870,31967004,POINT (-91.479264 40.6419764)
2006_44_HENRY_EXPEND_SA,2006,44,HENRY,2216148,785737,2295595,752630,3545550,665137,1017520,44800,0,1129347,12452464,856920,,13309384,0,2431098,15740482,POINT (-91.5445241 40.9879383)
2022_53_JONES_EXPEND_SA,2022,53,JONES,3529620,911044,900027,1793630,8082747,883483,2050876,274577,0,1195000,19621004,2579748,0,22200752,0,7129780,29330532,POINT (-91.1314352 42.1212397)
2010_6_BENTON_EXPEND_SA,2010,6,BENTON,4500530,851413,2158008,1763865,6304777,627560,1539662,0,0,6848838,24594653,3453379,0,28048032,0,3920025,31968057,POINT (-92.0656912 42.0801864)
2016_76_POCAHONTAS_EXPEND_SA,2016,76,POCAHONTAS,2080710,1523586,490090,1115077,4336766,375975,1594007,10385,14000,418353,11958949,1090000,0,13048949,0,9820550,22869499,POINT (-94.67874660000001 42.73413510000001)
2013_6_BENTON_EXPEND_SA,2013,6,BENTON,3843594,838611,2374649,2796162,6448500,861378,1742943,165000,100650,1820000,20991487,3267584,0,24259071,0,6588341,30847412,POINT (-92.0656912 42.0801864)
2012_23_CLINTON_EXPEND_SA,2012,23,CLINTON,7906674,1696034,9383112,1941879,6399050,1365294,3501982,170000,1382948,2928584,36675557,2210686,0,38886243,0,4894151,43780394,POINT (-90.5319724 41.8980358)
2017_88_UNION_EXPEND_SA,2017,88,UNION,1796795,516107,1219018,3587951,3769790,589496,995869,0,1426156,829650,14730832,927427,0,15658259,0,1949088,17607347,POINT (-94.2423792 41.0277304)
2009_77_POLK_EXPEND_SA,2009,77,POLK,57786445,30228895,50678265,10882652,11199560,6490720,32728973,100000,13316013,11559757,224971280,16149257,0,241120537,0,51573679,292694216,POINT (-93.5735335 41.6855048)
2017_46_HUMBOLDT_EXPEND_SA,2017,46,HUMBOLDT,2042235,386673,822618,756735,3650581,471450,1246768,0,87784,795000,10259844,1634137,0,11893981,0,4303308,16197289,POINT (-94.2071868 42.7764686)
2013_23_CLINTON_EXPEND_SA,2013,23,CLINTON,7774782,1637735,9499265,2003322,5595296,1368912,3885243,80000,1380988,760000,33985543,1558810,0,35544353,0,5400825,40945178,POINT (-90.5319724 41.8980358)
2018_41_HANCOCK_EXPEND_SA,2018,41,HANCOCK,2045496,450717,396065,655771,6436545,552727,1294228,190800,0,1346000,13368349,2358000,0,15726349,0,4327472,20053821,POINT (-93.7342723 43.0818861)
2017_73_PAGE_EXPEND_SA,2017,73,PAGE,2509821,677947,425961,440327,4554648,583868,1318901,4000,156563,209881,10881917,1299967,0,12181884,0,5465230,17647114,POINT (-95.1501747 40.7391444)
2012_6_BENTON_EXPEND_SA,2012,6,BENTON,4063154,867877,2557104,2444999,6355000,692128,1458839,165000,866525,2420500,21891126,4045629,0,25936755,0,6149360,32086115,POINT (-92.0656912 42.0801864)
2022_79_POWESHIEK_EXPEND_SA,2022,79,POWESHIEK,3730345,374491,280713,710906,7155430,750716,1341070,295788,1400708,4968276,21008443,3431811,0,24440254,0,9846635,34286889,POINT (-92.53146840000001 41.6864422)
2018_56_LEE_EXPEND_SA,2018,56,LEE,6064883,4784584,1483446,1501252,5844827,1368190,2446538,39680,1016328,947647,25497375,1778947,0,27276322,0,10603136,37879458,POINT (-91.479264 40.6419764)
2012_55_KOSSUTH_EXPEND_SA,2012,55,KOSSUTH,2806044,467622,2110600,899061,6331800,744609,1843309,70190,95919,1580000,16949154,2868900,0,19818054,0,7101547,26919601,POINT (-94.2067199 43.20413)
2014_23_CLINTON_EXPEND_SA,2014,23,CLINTON,7629888,1727504,3728764,2091633,5985867,1438297,4813858,40000,1390103,423000,29268914,1568350,0,30837264,0,6240872,37078136,POINT (-90.5319724 41.8980358)
2021_57_LINN_EXPEND_SA,2021,57,LINN,33173336,17542657,11522269,8566130,16319553,5614777,18272247,0,5499713,16079000,132589682,18976961,0,151566643,0,36724702,188291345,POINT (-91.5989646 42.0789478)
2014_55_KOSSUTH_EXPEND_SA,2014,55,KOSSUTH,3098635,353387,1044371,917785,6908250,800244,1984063,79215,0,1722000,16907950,2905841,0,19813791,0,6494843,26308634,POINT (-94.2067199 43.20413)
2015_74_PALO ALTO_EXPEND_SA,2015,74,PALO ALTO,1861598,420240,585159,1281386,4899700,427352,1229627,0,1231471,2119690,14056223,1393063,0,15449286,0,10978944,26428230,POINT (-94.6781371 43.0820643)
2008_44_HENRY_EXPEND_SA,2008,44,HENRY,2633520,768989,2618462,816385,3534500,514063,1050130,32200,149972,1119275,13237496,873508,0,14111004,0,3206086,17317090,POINT (-91.5445241 40.9879383)
2010_44_HENRY_EXPEND_SA,2010,44,HENRY,3140563,801864,2940606,925674,3611000,572160,1123157,43400,159516,1128400,14446340,981790,0,15428130,0,3916567,19344697,POINT (-91.5445241 40.9879383)
2018_68_MONROE_EXPEND_SA,2018,68,MONROE,2036634,842517,641364,537509,3594452,508624,1433840,0,708850,765000,11068790,1616479,0,12685269,0,2527872,15213141,POINT (-92.8689877 41.0297826)
2006_55_KOSSUTH_EXPEND_SA,2006,55,KOSSUTH,2313721,402187,1913400,655259,5227000,900096,1585576,59806,937852,1642500,15637397,2053763,,17691160,0,4274301,21965461,POINT (-94.2067199 43.20413)
2020_23_CLINTON_EXPEND_SA,2020,23,CLINTON,8877186,2153659,1852243,2025842,7322238,1279905,3809935,10000,2909180,3026491,33266679,2101135,0,35367814,0,-770086,34597728,POINT (-90.5319724 41.8980358)
2017_35_FRANKLIN_EXPEND_SA,2017,35,FRANKLIN,1718825,2099741,280030,1335765,5575000,493032,1925213,14800,2126438,1240000,16808844,2310549,195173,19314566,0,16232546,35547112,POINT (-93.262473 42.7325458)
2014_40_HAMILTON_EXPEND_SA,2014,40,HAMILTON,2824385,1807682,2346206,1374584,4542450,556497,1345561,0,2485720,1348631,18631716,2770022,0,21401738,0,2647759,24049497,POINT (-93.7068085 42.3837722)
2019_73_PAGE_EXPEND_SA,2019,73,PAGE,2982132,603264,323211,488581,4465000,633780,1564953,8000,429741,200000,11698662,1420771,0,13119433,0,5883613,19003046,POINT (-95.1501747 40.7391444)
2011_77_POLK_EXPEND_SA,2011,77,POLK,62702741,39063603,52862998,16504331,10018401,6780561,30399931,100000,13614534,11881033,243928133,20788065,0,264716198,0,58605633,323321831,POINT (-93.5735335 41.6855048)
2013_38_GRUNDY_EXPEND_SA,2013,38,GRUNDY,1824806,540785,872784,903522,4092326,410865,1748571,0,1269225,733248,12396132,1577600,0,13973732,0,3518397,17492129,POINT (-92.7914177 42.4018651)
2006_76_POCAHONTAS_EXPEND_SA,2006,76,POCAHONTAS,1141046,1403996,1136352,581794,3476500,324266,1011768,28385,0,1046000,10150107,610000,,10760107,0,4117204,14877311,POINT (-94.67874660000001 42.73413510000001)
2016_7_BLACK HAWK_EXPEND_SA,2016,7,BLACK HAWK,19926161,7875790,5527837,4579638,5757896,2411571,5716129,0,10860272,21907997,84563291,2979659,0,87542950,0,28250610,115793560,POINT (-92.3088197 42.4700957)
2009_9_BREMER_EXPEND_SA,2009,9,BREMER,2930910,664132,2316732,1825703,3652200,692345,1612659,0,468511,2282629,16445821,1883861,0,18329682,0,6770699,25100381,POINT (-92.31805480000001 42.7745873)
2017_9_BREMER_EXPEND_SA,2017,9,BREMER,3994149,1999313,1212722,1451658,5101800,788874,1669664,73526,327260,1565000,18183966,3159287,0,21343253,0,10472798,31816051,POINT (-92.31805480000001 42.7745873)
2022_64_MARSHALL_EXPEND_SA,2022,64,MARSHALL,10008328,623311,834536,1287843,8611100,1016388,3014485,0,606776,5964073,31966840,4179000,0,36145840,0,10405549,46551389,POINT (-92.9987706 42.0358499)
2014_8_BOONE_EXPEND_SA,2014,8,BOONE,3519446,791584,1294000,1735332,5844900,647996,1900212,0,736588,2268829,18738887,2863328,0,21602215,0,2163036,23765251,POINT (-93.931671 42.0365493)
2006_87_TAYLOR_EXPEND_SA,2006,87,TAYLOR,697115,845992,527359,155510,2589993,369954,572628,0,201839,4140000,10100390,481952,,10582342,0,598497,11180839,POINT (-94.6964148 40.73743240000001)
2015_12_BUTLER_EXPEND_SA,2015,12,BUTLER,2261624,1421227,23233722,1024925,4985000,790946,1798384,2500,546130,1060935,37125393,1938060,0,39063453,0,9233055,48296508,POINT (-92.7901934 42.7315661)
2017_56_LEE_EXPEND_SA,2017,56,LEE,5599415,4992060,1390419,1774146,5831547,1388321,2151678,40680,960863,769844,24898973,1722282,0,26621255,0,10391138,37012393,POINT (-91.479264 40.6419764)
2016_39_GUTHRIE_EXPEND_SA,2016,39,GUTHRIE,1504880,1461426,310548,1396995,4668693,431626,1033821,20000,278834,2945000,14051823,1692350,0,15744173,0,4400566,20144739,POINT (-94.501055 41.6837548)
2005_43_HARRISON_EXPEND_SA,2005,43,HARRISON,1637528,1325226,1756957,707094,4445000,410830,972439,0,571642,508346,12335062,1209000,,13544062,0,5664075,19208137,POINT (-95.8169209 41.6828528)
2019_6_BENTON_EXPEND_SA,2019,6,BENTON,5093322,1206450,1004249,3392272,8239499,819552,2181980,157000,730470,1851150,24675944,4961984,0,29637928,0,4166712,33804640,POINT (-92.0656912 42.0801864)
2020_92_WASHINGTON_EXPEND_SA,2020,92,WASHINGTON,6562777,2332940,761593,1245627,6872697,840670,2510430,13000,3212705,8222045,32574484,3575207,0,36149691,0,3458511,39608202,POINT (-91.7178676 41.335591)
2012_90_WAPELLO_EXPEND_SA,2012,90,WAPELLO,3603756,1662085,4971462,920761,3827650,731144,2808318,131390,314026,5318000,24288592,1000000,0,25288592,0,7378744,32667336,POINT (-92.4094499 41.03058450000001)
2019_56_LEE_EXPEND_SA,2019,56,LEE,6408175,4588388,1576783,1627269,6010570,1241533,2136703,87849,855774,1431932,25964976,1879984,0,27844960,0,8721093,36566053,POINT (-91.479264 40.6419764)
2012_17_CERRO GORDO_EXPEND_SA,2012,17,CERRO GORDO,7841578,5310139,2321758,1359759,5499290,1074561,2645981,0,993423,1800000,28846489,5443067,0,34289556,0,9833849,44123405,POINT (-93.2608184 43.081557700000005)
2013_50_JASPER_EXPEND_SA,2013,50,JASPER,5240269,1596308,4999314,1408204,6638780,1004057,3173203,30500,1902280,500377,26493292,4498313,0,30991605,0,6911277,37902882,POINT (-93.053765 41.6860394)
2009_22_CLAYTON_EXPEND_SA,2009,22,CLAYTON,2379331,575359,2111494,1112027,5679553,559962,1496031,1300,382725,2705000,17002782,1350000,0,18352782,0,4591063,22943845,POINT (-91.34143280000002 42.8447493)
2005_25_DALLAS_EXPEND_SA,2005,25,DALLAS,4357528,2601012,3616240,1701869,4671316,872538,3321686,212787,1086538,1125014,23566528,1868188,,25434716,0,7030291,32465007,POINT (-94.0397374 41.6848862)
2014_83_SHELBY_EXPEND_SA,2014,83,SHELBY,2139512,631942,1539889,433629,4565164,425347,1260111,11000,133824,562500,11702918,2853326,0,14556244,0,2330142,16886386,POINT (-95.31021130000002 41.6850926)
2013_94_WEBSTER_EXPEND_SA,2013,94,WEBSTER,5405177,2678524,4775657,1616634,6790000,894278,2747675,1758716,926374,2980000,30573035,3252818,0,33825853,0,10059062,43884915,POINT (-94.18178810000002 42.4279662)
2015_57_LINN_EXPEND_SA,2015,57,LINN,24888353,16741784,22586849,7032531,12504928,4266008,14455895,0,1750513,11131508,115358369,18158571,0,133516940,0,24416193,157933133,POINT (-91.5989646 42.0789478)
2007_91_WARREN_EXPEND_SA,2007,91,WARREN,3956650,2293252,3137044,874649,5289796,651863,2215120,0,700690,994765,20113829,2033483,,22147312,0,3498639,25645951,POINT (-93.5613594 41.3343735)
2021_30_DICKINSON_EXPEND_SA,2021,30,DICKINSON,3261986,603797,525996,7554432,6186060,945514,2619160,117300,1338330,2250000,25402575,4843260,0,30245835,0,9022338,39268173,POINT (-95.1508301 43.3779848)
2021_67_MONONA_EXPEND_SA,2021,67,MONONA,2330056,338607,216975,994628,6969931,575204,1870951,0,0,1591592,14887944,2036441,0,16924385,0,7908370,24832755,POINT (-95.9599235 42.0516663)
2021_62_MAHASKA_EXPEND_SA,2021,62,MAHASKA,4643494,791979,847555,1344023,7305900,701361,1671290,0,1120633,5470000,23896235,2916400,0,26812635,0,6647673,33460308,POINT (-92.6409094 41.3352035)
2018_73_PAGE_EXPEND_SA,2018,73,PAGE,3472852,577618,514890,483248,4540000,614756,1428192,3000,423087,745000,12802643,1433250,0,14235893,0,5294121,19530014,POINT (-95.1501747 40.7391444)
2021_18_CHEROKEE_EXPEND_SA,2021,18,CHEROKEE,2800609,399608,504031,1143734,5963424,630260,1623556,75000,0,8860000,22000222,2228787,0,24229009,0,1413410,25642419,POINT (-95.6238055 42.7356226)
2019_1_ADAIR_EXPEND_SA,2019,1,ADAIR,1861550,263315,273000,533069,5267881,465751,928240,0,2299210,10016739,21908755,1464609,0,23373364,0,6594337,29967701,POINT (-94.4709413 41.3307464)
2008_5_AUDUBON_EXPEND_SA,2008,5,AUDUBON,925031,591039,834600,509093,2882322,291065,684777,1120,412039,340575,7471661,637253,0,8108914,0,2302776,10411690,POINT (-94.9058222 41.6845893)
2022_42_HARDIN_EXPEND_SA,2022,42,HARDIN,5540767,530463,335543,2964759,7661000,768021,3027828,324282,213364,636500,22002527,2089465,0,24091992,0,5382106,29474098,POINT (-93.2404025 42.3838803)
2019_90_WAPELLO_EXPEND_SA,2019,90,WAPELLO,4433982,1143318,2037436,922965,5454204,725306,3087282,77943,780056,3002000,21664492,1200000,0,22864492,0,8639596,31504088,POINT (-92.4094499 41.03058450000001)
2008_24_CRAWFORD_EXPEND_SA,2008,24,CRAWFORD,1557600,2071597,2317210,800358,5028900,488164,1294128,0,167400,1330655,15056012,1145000,0,16201012,0,4139445,20340457,POINT (-95.3819678 42.0372125)
2010_71_O'BRIEN_EXPEND_SA,2010,71,O'BRIEN,2779231,589525,2118250,772896,3715300,511087,929127,8500,377560,452500,12253976,1230278,0,13484254,0,2079465,15563719,POINT (-95.6248784 43.0837527)
2018_80_RINGGOLD_EXPEND_SA,2018,80,RINGGOLD,1410831,876019,607209,322755,3371814,284186,842089,0,488119,393000,8596022,754780,0,9350802,0,3152064,12502866,POINT (-94.2439719 40.7352023)
2020_45_HOWARD_EXPEND_SA,2020,45,HOWARD,2002374,448172,509466,2581023,4659539,488797,1272681,5000,1868809,1032606,14868467,2038742,0,16907209,0,4517468,21424677,POINT (-92.3171989 43.3567673)
2009_41_HANCOCK_EXPEND_SA,2009,41,HANCOCK,1424257,2392665,1487500,548501,4495300,359830,1042524,5750,0,1596043,13352370,1690793,0,15043163,0,5925870,20969033,POINT (-93.7342723 43.0818861)
2005_38_GRUNDY_EXPEND_SA,2005,38,GRUNDY,1305557,549439,1181913,1172275,3274962,340530,1162176,0,199095,2728290,11914237,1036539,,12950776,0,2933914,15884690,POINT (-92.7914177 42.4018651)
2020_34_FLOYD_EXPEND_SA,2020,34,FLOYD,3509852,1680076,969080,823640,6603400,734121,1480410,0,1581940,9424881,26807400,1425418,0,28232818,0,8489542,36722360,POINT (-92.78900330000002 43.0599208)
2017_78_POTTAWATTAMIE_EXPEND_SA,2017,78,POTTAWATTAMIE,28403924,5193520,3161149,6805598,15309835,2436536,7753564,0,3895588,2305000,75264714,9425000,0,84689714,0,23854753,108544467,POINT (-95.5423935 41.3366123)
2022_21_CLAY_EXPEND_SA,2022,21,CLAY,3645599,719087,253484,1706015,5863826,971936,3028805,458000,856582,4299847,21803181,2225283,0,24028464,0,13454716,37483180,POINT (-95.1509194 43.0825804)
2017_41_HANCOCK_EXPEND_SA,2017,41,HANCOCK,1905574,339266,392443,609797,5800733,509478,1189655,16300,0,906000,11669246,2105483,0,13774729,0,5432041,19206770,POINT (-93.7342723 43.0818861)
2021_40_HAMILTON_EXPEND_SA,2021,40,HAMILTON,3798906,1823308,509015,2484214,5602000,579695,2048789,0,2802731,979835,20628493,3670536,0,24299029,0,4440211,28739240,POINT (-93.7068085 42.3837722)
2019_97_WOODBURY_EXPEND_SA,2019,97,WOODBURY,18349976,5315349,2340330,3077573,8500174,2570165,6496913,885641,2276507,4819050,54631678,9131494,0,63763172,922521,8996058,71836709,POINT (-96.0447673 42.3897169)
2005_26_DAVIS_EXPEND_SA,2005,26,DAVIS,805420,276655,829000,242218,2450000,316366,742637,20000,0,534000,6216296,584179,,6800475,0,710192,7510667,POINT (-92.4097173 40.7476891)
2017_67_MONONA_EXPEND_SA,2017,67,MONONA,1998949,535516,206908,909488,5738358,501339,1663122,0,0,2981592,14535272,1626616,0,16161888,0,4818214,20980102,POINT (-95.9599235 42.0516663)
2011_58_LOUISA_EXPEND_SA,2011,58,LOUISA,2179058,652212,1390725,3685247,3002682,264112,1130731,0,355600,1100383,13760750,1711836,0,15472586,0,3010834,18483420,POINT (-91.2596184 41.2185073)
2007_60_LYON_EXPEND_SA,2007,60,LYON,2166249,708198,1012037,690214,3378540,382272,873590,17420,286345,707045,10221910,1043000,,11264910,0,2890450,14155360,POINT (-96.2102924 43.380497)
2008_93_WAYNE_EXPEND_SA,2008,93,WAYNE,777608,705318,756498,501896,2597100,233058,714291,49450,25000,87000,6447219,488085,0,6935304,0,1098294,8033598,POINT (-93.3273639 40.73947020000001)
2021_45_HOWARD_EXPEND_SA,2021,45,HOWARD,2288219,458236,365150,2447178,4978059,478561,1297913,5000,1083747,1127772,14529835,2000370,0,16530205,0,5086539,21616744,POINT (-92.3171989 43.3567673)
2005_53_JONES_EXPEND_SA,2005,53,JONES,1678694,841517,2250595,580483,4934431,403522,956872,33069,0,2464000,14143183,962500,,15105683,0,3352109,18457792,POINT (-91.1314352 42.1212397)
2015_66_MITCHELL_EXPEND_SA,2015,66,MITCHELL,1657729,1831277,503700,1487990,3990000,346227,1403602,0,2781929,4650000,18652454,1211630,0,19864084,0,7690376,27554460,POINT (-92.7890315 43.3564124)
2019_24_CRAWFORD_EXPEND_SA,2019,24,CRAWFORD,2693089,2647706,491540,1047781,7958250,759502,1452533,0,155000,1080000,18285401,3721000,0,22006401,0,7087281,29093682,POINT (-95.3819678 42.0372125)
2012_32_EMMET_EXPEND_SA,2012,32,EMMET,1608203,705528,1728427,452261,3044829,406618,1044619,130000,0,48764,9169249,840066,0,10009315,0,1045704,11055019,POINT (-94.6784803 43.37802250000001)
2018_1_ADAIR_EXPEND_SA,2018,1,ADAIR,1557867,284925,252000,515771,5175374,448825,888357,0,1653740,9979173,20756032,1397472,0,22153504,0,5827678,27981182,POINT (-94.4709413 41.3307464)
2005_15_CASS_EXPEND_SA,2005,15,CASS,1555968,469270,1885100,527652,3581675,528674,896856,443000,0,1565514,11453709,1243457,,12697166,0,1328149,14025315,POINT (-94.9278266 41.3314876)
2022_27_DECATUR_EXPEND_SA,2022,27,DECATUR,1908949,710072,529771,1633347,3811591,422767,935884,0,259190,136200,10347771,668691,0,11016462,0,2301431,13317893,POINT (-93.7862815 40.7376827)
2010_76_POCAHONTAS_EXPEND_SA,2010,76,POCAHONTAS,1650883,1574116,1126116,943927,4026292,344515,1217985,7385,0,960000,11851219,950000,0,12801219,0,1264751,14065970,POINT (-94.67874660000001 42.73413510000001)
2019_45_HOWARD_EXPEND_SA,2019,45,HOWARD,1936976,440546,630628,2259558,4878592,457547,1237744,5000,1908911,3830906,17586408,1929366,0,19515774,0,3912229,23428003,POINT (-92.3171989 43.3567673)
2006_86_TAMA_EXPEND_SA,2006,86,TAMA,2780325,1250743,2030123,593654,5731474,681051,1164964,13000,0,2834901,17080235,1513413,,18593648,0,1732258,20325906,POINT (-92.5325425 42.07981170000001)
2022_78_POTTAWATTAMIE_EXPEND_SA,2022,78,POTTAWATTAMIE,36012813,4611229,2175518,7953612,16053596,2572543,9037818,0,3016600,4665000,86098729,8195450,0,94294179,0,41530433,135824612,POINT (-95.5423935 41.3366123)
2021_77_POLK_EXPEND_SA,2021,77,POLK,87975100,42252168,32265504,19265332,12154957,8805949,39545142,0,20539363,37433111,300236626,35469553,0,335706179,0,85551925,421258104,POINT (-93.5735335 41.6855048)
2018_12_BUTLER_EXPEND_SA,2018,12,BUTLER,2415781,1385187,634402,975747,5900000,604293,2042347,2500,592855,2204283,16757395,2457115,0,19214510,0,4009606,23224116,POINT (-92.7901934 42.7315661)
2012_27_DECATUR_EXPEND_SA,2012,27,DECATUR,1003376,1278697,1104978,392792,3062983,298010,684219,0,0,245000,8070055,458000,0,8528055,0,1868732,10396787,POINT (-93.7862815 40.7376827)
2012_93_WAYNE_EXPEND_SA,2012,93,WAYNE,1074487,896348,732341,480813,3285947,254693,550424,38200,401331,1196334,8910918,514758,0,9425676,0,1645319,11070995,POINT (-93.3273639 40.73947020000001)
2008_76_POCAHONTAS_EXPEND_SA,2008,76,POCAHONTAS,1330707,1597017,1144608,775636,3892300,325150,1070458,6885,0,412800,10555561,650000,0,11205561,0,4980729,16186290,POINT (-94.67874660000001 42.73413510000001)
2010_10_BUCHANAN_EXPEND_SA,2010,10,BUCHANAN,2391514,350296,3162226,1086506,5221000,553581,2136582,50823,473903,4255952,19682383,2132037,0,21814420,0,2851754,24666174,POINT (-91.8378392 42.4707777)
2006_12_BUTLER_EXPEND_SA,2006,12,BUTLER,1446305,1252140,1191850,667811,3870100,482946,1183561,2000,48883,1099000,11244596,1165350,,12409946,0,4597909,17007855,POINT (-92.7901934 42.7315661)
2018_44_HENRY_EXPEND_SA,2018,44,HENRY,3741107,1056533,933289,1128251,5159700,713698,1588886,68200,233000,1169000,15791664,1564229,0,17355893,0,4186426,21542319,POINT (-91.5445241 40.9879383)
2017_77_POLK_EXPEND_SA,2017,77,POLK,74288161,37803145,28229014,13332666,10885012,8103922,33240292,0,19306455,47004311,272192978,27825208,0,300018186,0,86102210,386120396,POINT (-93.5735335 41.6855048)
2010_93_WAYNE_EXPEND_SA,2010,93,WAYNE,1055840,755445,646441,514419,2638431,265664,794408,33750,416630,401611,7522639,490644,0,8013283,0,2106536,10119819,POINT (-93.3273639 40.73947020000001)
2018_37_GREENE_EXPEND_SA,2018,37,GREENE,1946626,523425,379399,681166,5227239,378633,1722171,260000,0,775286,11893945,1537500,0,13431445,0,3477683,16909128,POINT (-94.3968356 42.0362394)
2011_26_DAVIS_EXPEND_SA,2011,26,DAVIS,1036996,293416,634644,287907,2763606,345030,865837,20000,0,135000,6382436,630301,0,7012737,0,3158831,10171568,POINT (-92.4097173 40.7476891)
2013_47_IDA_EXPEND_SA,2013,47,IDA,757006,321260,841902,374936,3085340,252370,711704,0,0,351000,6695518,953869,0,7649387,0,2443135,10092522,POINT (-95.5134962 42.3868747)
2020_27_DECATUR_EXPEND_SA,2020,27,DECATUR,1738009,730004,320068,548999,3727711,381515,1049446,0,323162,140000,8958914,586241,0,9545155,0,2942155,12487310,POINT (-93.7862815 40.7376827)
2014_27_DECATUR_EXPEND_SA,2014,27,DECATUR,1049718,1360903,634949,386576,2983291,307825,624361,0,0,216000,7563623,464484,0,8028107,0,1957770,9985877,POINT (-93.7862815 40.7376827)
2012_10_BUCHANAN_EXPEND_SA,2012,10,BUCHANAN,2973593,575686,3327309,1210816,6106300,732806,1374269,52555,374563,752000,17479897,2028477,0,19508374,0,2923131,22431505,POINT (-91.8378392 42.4707777)
2012_59_LUCAS_EXPEND_SA,2012,59,LUCAS,1271609,704006,1009967,202566,3039570,297582,970857,0,42500,893000,8431657,780981,0,9212638,0,529597,9742235,POINT (-93.3277207 41.0293738)
2013_11_BUENA VISTA_EXPEND_SA,2013,11,BUENA VISTA,3309971,1250034,1837947,705058,4395335,710888,1517778,5400,890440,1995317,16618168,2208423,0,18826591,0,5320234,24146825,POINT (-95.15114900000002 42.7354936)
2006_27_DECATUR_EXPEND_SA,2006,27,DECATUR,771069,449029,1095794,244845,2703591,350655,568091,0,75000,297000,6555074,376660,,6931734,0,1325138,8256872,POINT (-93.7862815 40.7376827)
2008_48_IOWA_EXPEND_SA,2008,48,IOWA,2432140,897074,1484405,877473,4554425,491560,1463002,24120,607416,1976000,14807615,1276500,0,16084115,0,3887420,19971535,POINT (-92.065524 41.6863229)
2018_27_DECATUR_EXPEND_SA,2018,27,DECATUR,1525294,671418,415939,559130,3259871,350473,882816,0,324796,345000,8334737,490000,0,8824737,0,2037499,10862236,POINT (-93.7862815 40.7376827)
2017_92_WASHINGTON_EXPEND_SA,2017,92,WASHINGTON,4975701,2362902,772450,1101794,6337111,782899,2234785,20000,2528655,1498790,22615087,2841510,0,25456597,0,3275193,28731790,POINT (-91.7178676 41.335591)
2020_93_WAYNE_EXPEND_SA,2020,93,WAYNE,2012379,1053671,315489,385723,4099400,305370,1005348,20000,267154,490000,9954534,693313,0,10647847,0,3881157,14529004,POINT (-93.3273639 40.73947020000001)
2019_70_MUSCATINE_EXPEND_SA,2019,70,MUSCATINE,11411403,1180132,1693732,1493315,7119000,902756,3281761,0,1996875,4330000,33408974,3174355,0,36583329,0,12370711,48954040,POINT (-91.1127562 41.4839221)
2014_44_HENRY_EXPEND_SA,2014,44,HENRY,3388304,984910,781160,1023343,4514500,638157,1413187,53500,233100,1143990,14174151,1157107,0,15331258,0,5118286,20449544,POINT (-91.5445241 40.9879383)
2008_61_MADISON_EXPEND_SA,2008,61,MADISON,1955928,533503,1233280,562011,3743425,404366,902925,0,180806,78835,9595079,1006015,0,10601094,0,2753133,13354227,POINT (-94.01556190000001 41.33071420000001)
2017_4_APPANOOSE_EXPEND_SA,2017,4,APPANOOSE,2525860,904522,367203,889103,3517000,553290,1017033,0,155773,912000,10841784,678237,0,11520021,0,5256212,16776233,POINT (-92.8686104 40.7431635)
2006_98_WORTH_EXPEND_SA,2006,98,WORTH,1242986,991738,877000,686561,2135000,281829,753692,0,204845,321535,7495186,680000,,8175186,0,2442029,10617215,POINT (-93.2608476 43.3773984)
2019_77_POLK_EXPEND_SA,2019,77,POLK,78615198,41164083,23290633,14926953,11301446,8205464,34802429,0,19017413,36588687,267912306,17881780,0,285794086,0,103191394,388985480,POINT (-93.5735335 41.6855048)
2015_70_MUSCATINE_EXPEND_SA,2015,70,MUSCATINE,9215377,1319995,2933009,1167306,6095000,781309,2922082,0,1820750,3466000,29720828,1609500,0,31330328,0,8119204,39449532,POINT (-91.1127562 41.4839221)
2016_44_HENRY_EXPEND_SA,2016,44,HENRY,3348866,936600,2246892,1049629,4495140,668106,1446813,58500,233500,1178000,15662046,1373344,0,17035390,0,3625578,20660968,POINT (-91.5445241 40.9879383)
2014_59_LUCAS_EXPEND_SA,2014,59,LUCAS,1027154,734644,486279,237278,3317104,308913,910792,0,265199,651800,7939163,608100,0,8547263,0,721796,9269059,POINT (-93.3277207 41.0293738)
2010_48_IOWA_EXPEND_SA,2010,48,IOWA,2686170,931357,1398878,1110043,5473109,489270,1573541,67460,637549,1542248,15909625,1519476,0,17429101,0,3454904,20884005,POINT (-92.065524 41.6863229)
2009_65_MILLS_EXPEND_SA,2009,65,MILLS,2297260,1768598,1660692,755200,4580600,475481,1179114,0,0,510000,13226945,1400000,0,14626945,0,4941498,19568443,POINT (-95.62132670000001 41.0334523)
2006_59_LUCAS_EXPEND_SA,2006,59,LUCAS,806582,551096,1073245,224083,2871492,347324,792312,0,61865,2414000,9141999,494754,,9636753,0,453191,10089944,POINT (-93.3277207 41.0293738)
2020_61_MADISON_EXPEND_SA,2020,61,MADISON,3429597,803226,370900,959674,6393776,687069,1621380,0,135522,9907851,24308995,1892354,0,26201349,0,3978659,30180008,POINT (-94.01556190000001 41.33071420000001)
2013_26_DAVIS_EXPEND_SA,2013,26,DAVIS,1097388,341002,684432,316938,3059420,361715,879917,50000,176000,110000,7076812,839125,0,7915937,0,2786705,10702642,POINT (-92.4097173 40.7476891)
2014_12_BUTLER_EXPEND_SA,2014,12,BUTLER,2181267,1398725,19015413,890897,4945200,532345,1696912,230000,495800,1299000,32685559,2287500,0,34973059,0,11553362,46526421,POINT (-92.7901934 42.7315661)
2010_65_MILLS_EXPEND_SA,2010,65,MILLS,2417392,1783924,1750649,829187,4639992,500149,1471757,0,0,385000,13778050,1500000,0,15278050,0,4567343,19845393,POINT (-95.62132670000001 41.0334523)
2011_45_HOWARD_EXPEND_SA,2011,45,HOWARD,1327125,516432,1295832,1678970,3375388,359003,936672,1000,108912,96522,9695856,966711,0,10662567,0,2456063,13118630,POINT (-92.3171989 43.3567673)
2013_62_MAHASKA_EXPEND_SA,2013,62,MAHASKA,3029634,760057,2729603,944881,5005000,635992,1354490,955000,8490,160000,15583147,1863699,0,17446846,0,6897283,24344129,POINT (-92.6409094 41.3352035)
2018_93_WAYNE_EXPEND_SA,2018,93,WAYNE,1729099,913676,512870,459857,3460150,282435,960897,25000,268282,510000,9122266,517010,0,9639276,0,4200251,13839527,POINT (-93.3273639 40.73947020000001)
2015_98_WORTH_EXPEND_SA,2015,98,WORTH,2202344,1113893,388498,1007132,3835000,402763,1427823,0,1985788,2067793,14431034,1070703,0,15501737,0,3023485,18525222,POINT (-93.2608476 43.3773984)
2020_30_DICKINSON_EXPEND_SA,2020,30,DICKINSON,2919126,596484,411962,4696257,4897040,917230,2633846,138200,1339237,2825000,21374382,3799914,0,25174296,0,8460614,33634910,POINT (-95.1508301 43.3779848)
2006_91_WARREN_EXPEND_SA,2006,91,WARREN,3660440,2048393,2587629,815804,5079920,574409,1994255,0,617873,1098050,18476773,2183020,,20659793,0,3168711,23828504,POINT (-93.5613594 41.3343735)
2005_21_CLAY_EXPEND_SA,2005,21,CLAY,1899338,370727,1409407,820404,3453600,334416,1297840,16761,260535,1110720,10973748,1137816,,12111564,0,2799484,14911048,POINT (-95.1509194 43.0825804)
2016_59_LUCAS_EXPEND_SA,2016,59,LUCAS,1169609,734157,553488,365131,3820396,301994,1032709,0,286814,1019900,9284198,574531,0,9858729,0,1183178,11041907,POINT (-93.3277207 41.0293738)
2017_60_LYON_EXPEND_SA,2017,60,LYON,3284897,665700,461700,927115,5475657,525871,1271681,72520,247680,4380860,17313681,2726041,0,20039722,0,6681415,26721137,POINT (-96.2102924 43.380497)
2018_33_FAYETTE_EXPEND_SA,2018,33,FAYETTE,3954323,534101,1250820,1829022,6211731,822434,1735885,27400,435000,4046850,20847566,2057706,0,22905272,0,3132386,26037658,POINT (-91.8443207 42.8625919)
2022_22_CLAYTON_EXPEND_SA,2022,22,CLAYTON,3493748,588530,526470,1398434,7377452,777423,1962946,1000,92300,1232500,17450803,2000000,0,19450803,0,7634477,27085280,POINT (-91.34143280000002 42.8447493)
2009_26_DAVIS_EXPEND_SA,2009,26,DAVIS,1018957,311990,784160,315326,2879122,359548,887285,20000,0,0,6576388,586883,0,7163271,0,2221379,9384650,POINT (-92.4097173 40.7476891)
2013_79_POWESHIEK_EXPEND_SA,2013,79,POWESHIEK,2880437,386406,1556599,494990,5579051,734591,1234978,163728,603308,820500,14454588,2281775,0,16736363,0,4537980,21274343,POINT (-92.53146840000001 41.6864422)
2019_94_WEBSTER_EXPEND_SA,2019,94,WEBSTER,5689462,4498451,2166131,2173472,9000000,1073187,3202861,250000,1897328,4825000,34775892,6458555,0,41234447,0,10243607,51478054,POINT (-94.18178810000002 42.4279662)
2005_47_IDA_EXPEND_SA,2005,47,IDA,524435,451171,598262,436040,2111000,246504,669789,0,0,237000,5274201,652431,,5926632,0,1628196,7554828,POINT (-95.5134962 42.3868747)
2021_26_DAVIS_EXPEND_SA,2021,26,DAVIS,1977000,385933,417317,468412,4900276,440131,1119183,30539,400605,2400000,12539396,1114170,0,13653566,0,2043735,15697301,POINT (-92.4097173 40.7476891)
2014_79_POWESHIEK_EXPEND_SA,2014,79,POWESHIEK,2940278,394231,1265798,478846,5783638,718535,1256095,211222,605603,991500,14645746,2426833,0,17072579,0,4705941,21778520,POINT (-92.53146840000001 41.6864422)
2005_94_WEBSTER_EXPEND_SA,2005,94,WEBSTER,4236243,2068776,4300780,858687,4950000,615228,2232930,90000,325612,3100000,22778256,2290400,,25068656,0,6798420,31867076,POINT (-94.18178810000002 42.4279662)
2011_13_CALHOUN_EXPEND_SA,2011,13,CALHOUN,1934959,2634445,1090000,797282,4037290,510487,1101068,64725,0,866000,13036256,1424719,0,14460975,0,2928567,17389542,POINT (-94.6404136 42.385184800000005)
2018_61_MADISON_EXPEND_SA,2018,61,MADISON,3096389,854078,351216,834266,6119428,473683,1309921,0,138001,1760577,14937559,1855246,0,16792805,0,3341382,20134187,POINT (-94.01556190000001 41.33071420000001)
2020_88_UNION_EXPEND_SA,2020,88,UNION,1989033,469264,495156,648398,3864009,550243,1249389,0,1931723,5109440,16306655,1001273,0,17307928,0,5110896,22418824,POINT (-94.2423792 41.0277304)
2015_24_CRAWFORD_EXPEND_SA,2015,24,CRAWFORD,2122940,2910449,919039,1200820,6600400,654170,1299640,0,247000,293650,16248108,2965000,0,19213108,0,6554443,25767551,POINT (-95.3819678 42.0372125)
2007_87_TAYLOR_EXPEND_SA,2007,87,TAYLOR,722337,917156,552203,254281,2478000,276191,580007,0,89582,400000,6269757,526371,,6796128,0,1025536,7821664,POINT (-94.6964148 40.73743240000001)
2012_78_POTTAWATTAMIE_EXPEND_SA,2012,78,POTTAWATTAMIE,20572867,3622130,11004088,7598172,11685390,2047525,5944028,0,3825448,6598395,72898043,7064851,0,79962894,0,16155935,96118829,POINT (-95.5423935 41.3366123)
2022_59_LUCAS_EXPEND_SA,2022,59,LUCAS,1375626,620804,336518,463435,4344504,383447,1415322,0,0,504000,9443656,803106,0,10246762,0,1220587,11467349,POINT (-93.3277207 41.0293738)
2019_13_CALHOUN_EXPEND_SA,2019,13,CALHOUN,3205930,1628296,374059,1095837,5481150,614281,1577597,305300,0,953500,15235950,1546145,0,16782095,0,7142641,23924736,POINT (-94.6404136 42.385184800000005)
2013_90_WAPELLO_EXPEND_SA,2013,90,WAPELLO,3686830,1624913,5812104,931141,3952050,717839,2865901,132933,311860,2916500,22952071,1300000,0,24252071,0,7408623,31660694,POINT (-92.4094499 41.03058450000001)
2009_21_CLAY_EXPEND_SA,2009,21,CLAY,2240532,498103,1664042,1005674,4399306,441800,1617747,0,403400,1622000,13892604,1244138,0,15136742,0,4773585,19910327,POINT (-95.1509194 43.0825804)
2016_27_DECATUR_EXPEND_SA,2016,27,DECATUR,1283470,794310,1242654,427914,2781871,320962,693930,0,319978,110000,7975089,464484,0,8439573,0,1412367,9851940,POINT (-93.7862815 40.7376827)
2008_29_DES MOINES_EXPEND_SA,2008,29,DES MOINES,5454534,2543616,4681502,1617531,3857432,773110,4986052,0,196570,3648170,27758517,1531690,0,29290207,0,3894352,33184559,POINT (-91.1814707 40.9231829)
2006_54_KEOKUK_EXPEND_SA,2006,54,KEOKUK,882617,664265,1007371,451075,4296200,492441,931219,1000,5900,390000,9122088,870000,,9992088,0,1774057,11766145,POINT (-92.1786426 41.336465)
2020_84_SIOUX_EXPEND_SA,2020,84,SIOUX,4884571,1282520,787140,1868101,7628220,1150032,2755417,242600,1323360,9079750,31001711,4550721,0,35552432,0,14835492,50387924,POINT (-96.1778827 43.0826174)
2007_31_DUBUQUE_EXPEND_SA,2007,31,DUBUQUE,10422684,12542323,8613962,2530884,5885171,1325101,2806082,108750,496800,3484791,48216548,5991152,,54207700,0,2864845,57072545,POINT (-90.8824564 42.468832)
2021_58_LOUISA_EXPEND_SA,2021,58,LOUISA,3384337,802866,437312,1142837,4090440,420744,1466285,0,339790,2005680,14090291,2103970,0,16194261,0,3417120,19611381,POINT (-91.2596184 41.2185073)
2007_92_WASHINGTON_EXPEND_SA,2007,92,WASHINGTON,2886047,2325364,1699500,566595,4317000,594358,1502018,1867300,975459,6927200,23660841,2606356,,26267197,0,2956549,29223746,POINT (-91.7178676 41.335591)
2022_91_WARREN_EXPEND_SA,2022,91,WARREN,8227270,2820277,767100,1689490,9472725,1018651,3622300,0,3244325,19113621,49975759,4825000,0,54800759,0,11934092,66734851,POINT (-93.5613594 41.3343735)
2009_53_JONES_EXPEND_SA,2009,53,JONES,2055261,855324,2554384,1168798,5033997,572244,1352507,147150,33896,2146000,15919561,1576500,0,17496061,0,2588064,20084125,POINT (-91.1314352 42.1212397)
2020_10_BUCHANAN_EXPEND_SA,2020,10,BUCHANAN,4130363,704124,1728181,1295774,7478600,869252,2192708,64175,542529,1061600,20067306,2389412,0,22456718,0,1674845,24131563,POINT (-91.8378392 42.4707777)
2005_58_LOUISA_EXPEND_SA,2005,58,LOUISA,1550259,566961,1219288,441751,2534900,272485,792205,0,56440,941039,8375328,1133761,,9509089,0,2029599,11538688,POINT (-91.2596184 41.2185073)
2008_20_CLARKE_EXPEND_SA,2008,20,CLARKE,1512770,1029310,974836,282566,2393250,336187,770968,0,587200,550800,8437887,863441,0,9301328,0,3850953,13152281,POINT (-93.78515790000002 41.0290323)
2018_76_POCAHONTAS_EXPEND_SA,2018,76,POCAHONTAS,2242156,1660725,442305,1176607,5148461,403095,1626259,11385,0,3542004,16252997,1350000,0,17602997,0,3706814,21309811,POINT (-94.67874660000001 42.73413510000001)
2005_79_POWESHIEK_EXPEND_SA,2005,79,POWESHIEK,1450473,406502,1364713,1443405,3905852,462363,998665,109804,43237,48500,10233514,1354566,,11588080,0,3586301,15174381,POINT (-92.53146840000001 41.6864422)
2022_96_WINNESHIEK_EXPEND_SA,2022,96,WINNESHIEK,4668090,1615466,599730,3038172,7415700,756109,2948238,4500,0,2805000,23851005,2795191,0,26646196,0,7465695,34111891,POINT (-91.8437074 43.2906746)
2016_12_BUTLER_EXPEND_SA,2016,12,BUTLER,2365119,1469280,589899,1199248,5185000,645482,1842816,2500,601102,1895120,15795566,2174715,0,17970281,0,6309200,24279481,POINT (-92.7901934 42.7315661)
2007_64_MARSHALL_EXPEND_SA,2007,64,MARSHALL,6241474,946264,3288630,815885,5432800,850912,2481107,0,701783,1582325,22341180,1785262,,24126442,0,2843609,26970051,POINT (-92.9987706 42.0358499)
2017_45_HOWARD_EXPEND_SA,2017,45,HOWARD,1846017,525330,629403,2117357,4369706,440160,1174232,5000,1567211,632761,13307177,1665965,0,14973142,0,3605924,18579066,POINT (-92.3171989 43.3567673)
2005_30_DICKINSON_EXPEND_SA,2005,30,DICKINSON,1745113,498806,1430278,1272406,2715200,429033,1530438,40500,1186201,10900397,21748372,1660140,,23408512,0,9658941,33067453,POINT (-95.1508301 43.3779848)
2007_19_CHICKASAW_EXPEND_SA,2007,19,CHICKASAW,1248510,1322639,1045781,601977,3428300,361634,1021428,0,0,764300,9794569,2291133,,12085702,0,4115865,16201567,POINT (-92.3176637 43.06004140000001)
2020_5_AUDUBON_EXPEND_SA,2020,5,AUDUBON,1583545,747780,172655,791897,4314115,492917,1063409,100,356500,108995,9631913,1156590,0,10788503,0,2734129,13522632,POINT (-94.9058222 41.6845893)
2019_30_DICKINSON_EXPEND_SA,2019,30,DICKINSON,2901759,568558,319868,4166752,4598580,912902,2506702,147600,1416492,2750700,20289913,3570774,0,23860687,0,7635958,31496645,POINT (-95.1508301 43.3779848)
2009_80_RINGGOLD_EXPEND_SA,2009,80,RINGGOLD,942965,752127,989511,287065,2582896,261806,1321863,12500,238681,2880000,10269414,586286,0,10855700,0,397847,11253547,POINT (-94.2439719 40.7352023)
2014_34_FLOYD_EXPEND_SA,2014,34,FLOYD,2287215,1730271,878330,692721,4996600,612601,1186920,0,381228,1217000,13982886,1496733,0,15479619,0,6316379,21795998,POINT (-92.78900330000002 43.0599208)
2009_97_WOODBURY_EXPEND_SA,2009,97,WOODBURY,12311825,5259762,12155068,2442097,7373269,2274893,6598504,10000,635040,2766773,51827231,5694344,0,57521575,0,8202521,65724096,POINT (-96.0447673 42.3897169)
2006_66_MITCHELL_EXPEND_SA,2006,66,MITCHELL,1157810,1175887,1442781,599056,2565000,294800,717564,500,336790,1345000,9635188,944000,,10579188,0,1633950,12213138,POINT (-92.7890315 43.3564124)
2019_80_RINGGOLD_EXPEND_SA,2019,80,RINGGOLD,1485909,959053,860507,339909,3965996,276217,949505,0,513254,400000,9750350,813975,0,10564325,0,3798624,14362949,POINT (-94.2439719 40.7352023)
2018_16_CEDAR_EXPEND_SA,2018,16,CEDAR,4103026,1412565,1118732,2109765,6591500,544683,1864377,6500,0,1660000,19411148,2419335,0,21830483,0,3727328,25557811,POINT (-91.1324125 41.7723207)
2012_64_MARSHALL_EXPEND_SA,2012,64,MARSHALL,7191950,953556,4022465,1078720,6012700,985376,2467726,0,595050,1262075,24569618,2255900,0,26825518,0,6308027,33133545,POINT (-92.9987706 42.0358499)
2021_81_SAC_EXPEND_SA,2021,81,SAC,3089230,806944,312424,1157601,5494155,542210,1502713,0,0,2580000,15485277,1679750,0,17165027,0,2711100,19876127,POINT (-95.1053946 42.3862604)
2022_32_EMMET_EXPEND_SA,2022,32,EMMET,2293746,866204,282121,596536,3959620,598306,1304174,200000,0,71400,10172107,1180449,0,11352556,0,4710237,16062793,POINT (-94.6784803 43.37802250000001)
2012_97_WOODBURY_EXPEND_SA,2012,97,WOODBURY,13114874,5237704,11969388,2349710,7062740,2279970,6398202,10000,854372,2398826,51675786,6444306,0,58120092,0,4738818,62858910,POINT (-96.0447673 42.3897169)
2006_81_SAC_EXPEND_SA,2006,81,SAC,1559600,541678,1254650,575893,3343260,295961,926155,0,0,1065000,9562197,802081,,10364278,0,1866508,12230786,POINT (-95.1053946 42.3862604)
2019_65_MILLS_EXPEND_SA,2019,65,MILLS,4326579,2242199,314412,2185413,6796951,609012,3135861,0,653475,2441211,22705113,2390737,0,25095850,0,4426117,29521967,POINT (-95.62132670000001 41.0334523)
2010_97_WOODBURY_EXPEND_SA,2010,97,WOODBURY,12683957,5556874,12275353,2154481,7751824,2333560,5778740,0,727160,3532966,52794915,6475038,0,59269953,0,7212827,66482780,POINT (-96.0447673 42.3897169)
2018_87_TAYLOR_EXPEND_SA,2018,87,TAYLOR,1608054,1396615,95509,281172,4298000,393060,813244,0,961724,900000,10747378,825962,0,11573340,0,2987820,14561160,POINT (-94.6964148 40.73743240000001)
2009_48_IOWA_EXPEND_SA,2009,48,IOWA,2487573,911310,1581290,913332,5272720,489574,1531990,57032,642289,2217310,16104420,1423780,0,17528200,0,3174231,20702431,POINT (-92.065524 41.6863229)
2015_51_JEFFERSON_EXPEND_SA,2015,51,JEFFERSON,2841164,990291,794315,666128,3420814,552937,1037479,4200,253450,332500,10893278,1209814,0,12103092,0,3156671,15259763,POINT (-91.9488774 41.0317596)
2016_21_CLAY_EXPEND_SA,2016,21,CLAY,2903107,794288,542899,1521382,5437184,454767,1752712,0,500348,3135150,17041837,2781558,0,19823395,0,3615942,23439337,POINT (-95.1509194 43.0825804)
2021_49_JACKSON_EXPEND_SA,2021,49,JACKSON,2924084,528006,562431,2287074,6490386,819794,2156390,0,0,693100,16461265,1341400,0,17802665,0,6570523,24373188,POINT (-90.5742294 42.1717426)
2008_25_DALLAS_EXPEND_SA,2008,25,DALLAS,6560601,3078057,4784613,2953971,5556514,1532542,3711305,32050,1335874,4076194,33621721,3166127,0,36787848,0,8144464,44932312,POINT (-94.0397374 41.6848862)
2008_80_RINGGOLD_EXPEND_SA,2008,80,RINGGOLD,862510,756392,952171,275892,2530329,241455,1111644,12500,238681,2712000,9693574,547182,0,10240756,0,290824,10531580,POINT (-94.2439719 40.7352023)
2019_33_FAYETTE_EXPEND_SA,2019,33,FAYETTE,4095608,444649,875030,1952218,6241271,849625,1752780,29650,0,4161850,20402681,2283522,0,22686203,0,3054592,25740795,POINT (-91.8443207 42.8625919)
2011_30_DICKINSON_EXPEND_SA,2011,30,DICKINSON,2256119,575024,1487323,2200101,3697540,606016,1803778,105000,1966874,1555882,16253657,2854176,0,19107833,0,7125435,26233268,POINT (-95.1508301 43.3779848)
2018_48_IOWA_EXPEND_SA,2018,48,IOWA,4832669,1322545,681882,1076596,6954000,676048,2817908,79080,661767,3345103,22447598,1315000,0,23762598,0,6635089,30397687,POINT (-92.065524 41.6863229)
2007_14_CARROLL_EXPEND_SA,2007,14,CARROLL,2447940,1014682,2974649,834209,3827500,411421,1208158,250000,119000,912360,13999919,1071600,,15071519,0,2217847,17289366,POINT (-94.8605593 42.0362382)
2011_53_JONES_EXPEND_SA,2011,53,JONES,2133408,831163,2746599,754016,5560840,578586,1372055,118645,36524,1225000,15356836,1932500,0,17289336,0,1910948,19200284,POINT (-91.1314352 42.1212397)
2007_56_LEE_EXPEND_SA,2007,56,LEE,3484240,3698989,4313544,1273781,3754607,1000264,2137445,0,1839640,1270000,22772510,1022000,,23794510,0,3593111,27387621,POINT (-91.479264 40.6419764)
2021_99_WRIGHT_EXPEND_SA,2021,99,WRIGHT,4234742,2061232,386700,1458106,5255849,643082,1704285,62962,3569590,2374000,21750548,1976395,0,23726943,0,3228546,26955489,POINT (-93.7351465 42.7331189)
2009_90_WAPELLO_EXPEND_SA,2009,90,WAPELLO,3491820,1719530,4711481,924732,3436685,616554,2658355,128387,0,1040000,18727544,1100000,0,19827544,0,6710798,26538342,POINT (-92.4094499 41.03058450000001)
2016_48_IOWA_EXPEND_SA,2016,48,IOWA,4486623,1103652,814883,1139103,5966503,806738,1535505,117761,2314756,1058000,19343524,1315000,0,20658524,0,5850545,26509069,POINT (-92.065524 41.6863229)
2013_43_HARRISON_EXPEND_SA,2013,43,HARRISON,2206470,1462858,2053750,910022,5703000,512506,1960725,0,227600,1168500,16205431,1590000,0,17795431,0,7391886,25187317,POINT (-95.8169209 41.6828528)
2006_8_BOONE_EXPEND_SA,2006,8,BOONE,2620770,770344,2282895,1031077,4572200,770466,1276061,0,414445,1059200,14797458,1716169,,16513627,0,2872882,19386509,POINT (-93.931671 42.0365493)
2007_41_HANCOCK_EXPEND_SA,2007,41,HANCOCK,1320883,3146862,1300000,542860,4248000,315298,1116824,6750,0,1485000,13482477,1725000,,15207477,0,5168739,20376216,POINT (-93.7342723 43.0818861)
2006_23_CLINTON_EXPEND_SA,2006,23,CLINTON,4917339,1337354,7398469,1311065,4969946,1055314,2472503,292000,0,1056700,24810690,689037,,25499727,0,3583954,29083681,POINT (-90.5319724 41.8980358)
2010_20_CLARKE_EXPEND_SA,2010,20,CLARKE,1864815,1087215,1277372,255915,2867450,368372,818454,0,258870,728500,9526963,572918,0,10099881,0,1157081,11256962,POINT (-93.78515790000002 41.0290323)
2016_63_MARION_EXPEND_SA,2016,63,MARION,4521241,2623664,1140803,1976368,6403328,978322,2831798,0,450000,983211,21908735,2304370,0,24213105,0,11614524,35827629,POINT (-93.0994367 41.3344515)
2014_47_IDA_EXPEND_SA,2014,47,IDA,775208,307166,220657,389447,2909803,260203,717251,0,0,570000,6149735,1000461,0,7150196,0,2742284,9892480,POINT (-95.5134962 42.3868747)
2018_97_WOODBURY_EXPEND_SA,2018,97,WOODBURY,17112446,5107929,1806855,2766917,8708179,2671897,6669153,20000,2220186,5886580,52970142,9987470,0,62957612,0,10845801,73803413,POINT (-96.0447673 42.3897169)
2015_31_DUBUQUE_EXPEND_SA,2015,31,DUBUQUE,13879168,12767024,5160906,3093966,8146912,1324523,4134843,914788,590264,5419607,55432001,6803299,0,62235300,0,15705796,77941096,POINT (-90.8824564 42.468832)
2008_52_JOHNSON_EXPEND_SA,2008,52,JOHNSON,14885587,7683826,14221785,2915857,6698375,2051626,6355539,0,831084,10292390,65936069,19105076,0,85041145,0,11141667,96182812,POINT (-91.5880849 41.6715511)
2010_80_RINGGOLD_EXPEND_SA,2010,80,RINGGOLD,979187,842171,973944,254991,2810058,273951,1369252,12500,42682,3103500,10662236,608522,0,11270758,0,736333,12007091,POINT (-94.2439719 40.7352023)
2021_94_WEBSTER_EXPEND_SA,2021,94,WEBSTER,6147857,4656243,1088310,2352140,9281200,1178620,3373512,0,3038350,13022538,44138770,5986807,0,50125577,0,15006275,65131852,POINT (-94.18178810000002 42.4279662)
2013_15_CASS_EXPEND_SA,2013,15,CASS,2459672,512095,2582950,451574,4783234,475983,1351445,1185649,310292,1909709,16022603,2419415,0,18442018,0,1312765,19754783,POINT (-94.9278266 41.3314876)
2005_85_STORY_EXPEND_SA,2005,85,STORY,7293602,1898803,8171275,2266251,4601425,1109757,4110270,0,1193808,2741000,33386191,2236609,,35622800,0,7043745,42666545,POINT (-93.4650448 42.0362415)
2020_97_WOODBURY_EXPEND_SA,2020,97,WOODBURY,19583537,5603015,4478207,3815373,8881404,2598275,6469419,874060,1440523,4436581,58180394,9209738,0,67390132,0,11474931,78865063,POINT (-96.0447673 42.3897169)
2008_57_LINN_EXPEND_SA,2008,57,LINN,20755972,15957338,28946501,5735215,10802533,3431279,10180383,17854,1249380,2350000,99426455,10133029,0,109559484,0,21162383,130721867,POINT (-91.5989646 42.0789478)
2014_76_POCAHONTAS_EXPEND_SA,2014,76,POCAHONTAS,1844687,1444211,732230,1041643,4341439,364110,1410993,10385,0,790000,11979698,1090000,0,13069698,0,3458756,16528454,POINT (-94.67874660000001 42.73413510000001)
2016_95_WINNEBAGO_EXPEND_SA,2016,95,WINNEBAGO,1830894,1364032,820658,967935,3485675,595062,1935382,9990,2344078,510461,13864167,1566652,0,15430819,0,1669676,17100495,POINT (-93.7341955 43.37756780000001)
2017_96_WINNESHIEK_EXPEND_SA,2017,96,WINNESHIEK,2988035,1407576,970129,1971366,7059400,627956,2694641,6000,0,5293000,23018103,2596619,0,25614722,0,5984421,31599143,POINT (-91.8437074 43.2906746)
2015_62_MAHASKA_EXPEND_SA,2015,62,MAHASKA,3236003,805535,913372,812688,5230000,641433,1271695,925000,8490,160000,14004216,2042135,0,16046351,0,6685547,22731898,POINT (-92.6409094 41.3352035)
2013_30_DICKINSON_EXPEND_SA,2013,30,DICKINSON,2315500,591120,1679330,2460624,3499982,746133,1954225,196000,1723617,1960000,17126531,3080027,0,20206558,0,7443217,27649775,POINT (-95.1508301 43.3779848)
2014_15_CASS_EXPEND_SA,2014,15,CASS,2536483,535357,1171840,510358,4775000,664921,1577383,1197589,234369,1398053,14601353,2678073,0,17279426,0,1983083,19262509,POINT (-94.9278266 41.3314876)
2009_85_STORY_EXPEND_SA,2009,85,STORY,8992934,1932354,9342580,2931561,4841154,1846826,4544235,0,1207818,2003508,37642970,2150000,0,39792970,0,5354467,45147437,POINT (-93.4650448 42.0362415)
2011_9_BREMER_EXPEND_SA,2011,9,BREMER,3252766,1119888,2310367,1233673,4059700,621507,1495186,83000,466036,2847000,17489123,2639906,0,20129029,0,8329499,28458528,POINT (-92.31805480000001 42.7745873)
2014_91_WARREN_EXPEND_SA,2014,91,WARREN,4729099,4133726,1135329,1271953,6711413,899764,2670614,0,46332,2487662,24085892,2978175,0,27064067,0,7373678,34437745,POINT (-93.5613594 41.3343735)
2012_74_PALO ALTO_EXPEND_SA,2012,74,PALO ALTO,1688484,364107,1560386,1635536,4232339,427491,1235869,0,1189678,5489280,17823170,1281252,0,19104422,0,455176,19559598,POINT (-94.6781371 43.0820643)
2006_49_JACKSON_EXPEND_SA,2006,49,JACKSON,1391506,419988,2088198,924721,3763834,402154,1088052,144246,30729,499313,10752741,750000,,11502741,0,3654300,15157041,POINT (-90.5742294 42.1717426)
2016_81_SAC_EXPEND_SA,2016,81,SAC,2433956,785047,610533,852290,5253200,487207,1433727,0,55000,1042000,12952960,1504107,0,14457067,0,3911691,18368758,POINT (-95.1053946 42.3862604)
2009_2_ADAMS_EXPEND_SA,2009,2,ADAMS,835034,453670,495361,664839,2599800,215781,619930,42572,287869,1351221,7566077,612887,0,8178964,0,1408591,9587555,POINT (-94.6991849 41.02898390000001)
2011_94_WEBSTER_EXPEND_SA,2011,94,WEBSTER,4915897,2362008,5043612,1169634,6300000,791096,2534589,200000,572436,2950000,26839272,2080000,0,28919272,0,5421127,34340399,POINT (-94.18178810000002 42.4279662)
2018_91_WARREN_EXPEND_SA,2018,91,WARREN,5592741,3468208,1109726,1558021,6654030,967306,3071209,0,96138,2064000,24581379,3242550,0,27823929,0,10220761,38044690,POINT (-93.5613594 41.3343735)
2007_83_SHELBY_EXPEND_SA,2007,83,SHELBY,1560263,433785,1963496,334152,4596232,363788,994550,55820,221138,644268,11167492,1553628,,12721120,0,2435646,15156766,POINT (-95.31021130000002 41.6850926)
2017_28_DELAWARE_EXPEND_SA,2017,28,DELAWARE,2845741,569405,1663787,1022439,6406213,771031,2219477,44300,469728,2003930,18016051,2453493,0,20469544,0,4921016,25390560,POINT (-91.3673502 42.471211)
2005_62_MAHASKA_EXPEND_SA,2005,62,MAHASKA,2661437,868999,2493683,665774,3930600,474834,1079145,630000,0,1048000,13852472,1343534,,15196006,0,9736963,24932969,POINT (-92.6409094 41.3352035)
2011_41_HANCOCK_EXPEND_SA,2011,41,HANCOCK,1423545,1651005,1549000,529713,4713300,339827,944349,1950,0,1269000,12421689,1715000,0,14136689,0,3723409,17860098,POINT (-93.7342723 43.0818861)
2013_86_TAMA_EXPEND_SA,2013,86,TAMA,3419500,1494423,1514095,810642,7238543,505470,1285454,7750,0,2664774,18940651,2229846,0,21170497,0,3541246,24711743,POINT (-92.5325425 42.07981170000001)
2011_99_WRIGHT_EXPEND_SA,2011,99,WRIGHT,1782846,3416655,1575095,1088297,3945750,504315,1179346,26720,247645,1206000,14972669,1552481,0,16525150,0,3264441,19789591,POINT (-93.7351465 42.7331189)
2012_42_HARDIN_EXPEND_SA,2012,42,HARDIN,3527337,262093,1950470,1148961,5055368,480656,1615759,259180,918363,3456800,18674987,2841618,0,21516605,0,7584723,29101328,POINT (-93.2404025 42.3838803)
2007_24_CRAWFORD_EXPEND_SA,2007,24,CRAWFORD,1454362,1896580,1954681,809374,5194000,528177,1207388,0,165000,2913000,16122562,1161000,,17283562,0,3684318,20967880,POINT (-95.3819678 42.0372125)
2019_62_MAHASKA_EXPEND_SA,2019,62,MAHASKA,4622003,792671,1196904,1090841,7211000,683622,1540964,25000,400828,1285358,18849191,2440155,0,21289346,0,5838387,27127733,POINT (-92.6409094 41.3352035)
2007_96_WINNESHIEK_EXPEND_SA,2007,96,WINNESHIEK,1888796,1554843,2506351,1138379,4682970,320009,1285604,6000,551156,1603759,15537867,1974813,,17512680,0,4141338,21654018,POINT (-91.8437074 43.2906746)
2014_66_MITCHELL_EXPEND_SA,2014,66,MITCHELL,1568211,1759109,753560,1420387,3950000,327207,1383267,0,1701444,5750000,18613185,1444553,0,20057738,0,3388886,23446624,POINT (-92.7890315 43.3564124)
2013_75_PLYMOUTH_EXPEND_SA,2013,75,PLYMOUTH,3156851,371201,1835100,969183,6956000,909975,4110834,0,778691,2565000,21652835,2759100,0,24411935,0,4062757,28474692,POINT (-96.2140431 42.7378346)
2015_83_SHELBY_EXPEND_SA,2015,83,SHELBY,2213203,664982,1103376,404065,4685300,446894,1198963,30000,34000,681551,11462334,2651815,0,14114149,0,2319194,16433343,POINT (-95.31021130000002 41.6850926)
2009_58_LOUISA_EXPEND_SA,2009,58,LOUISA,1969819,639812,1285922,868340,2955380,278481,1190367,0,434558,5029057,14651736,1543305,0,16195041,0,2054368,18249409,POINT (-91.2596184 41.2185073)
2016_31_DUBUQUE_EXPEND_SA,2016,31,DUBUQUE,14363042,3322968,4266734,3335725,8919670,1531467,4768675,1019018,909916,3642526,46079741,5864613,0,51944354,0,18066100,70010454,POINT (-90.8824564 42.468832)
2006_34_FLOYD_EXPEND_SA,2006,34,FLOYD,1856786,1182326,1758000,513326,4825850,679312,855968,0,255735,777000,12704303,819269,,13523572,0,4498024,18021596,POINT (-92.78900330000002 43.0599208)
2021_39_GUTHRIE_EXPEND_SA,2021,39,GUTHRIE,2384159,1670834,286919,1678267,6386890,484671,2032969,24500,1068295,730000,16747504,2429627,0,19177131,0,4755656,23932787,POINT (-94.501055 41.6837548)
2012_82_SCOTT_EXPEND_SA,2012,82,SCOTT,28483717,6294948,16584651,4906623,5586280,2271277,9648287,0,4369070,3091119,81235972,10322530,0,91558502,0,15770727,107329229,POINT (-90.6232428 41.6370978)
2019_9_BREMER_EXPEND_SA,2019,9,BREMER,4498717,1587199,1048618,1508262,5542170,780814,1804598,13258,321535,1425000,18530171,3407759,0,21937930,0,11355581,33293511,POINT (-92.31805480000001 42.7745873)
2009_1_ADAIR_EXPEND_SA,2009,1,ADAIR,931279,234376,930212,344440,3534000,264357,665119,0,310430,911000,8125213,1489472,0,9614685,0,2161188,11775873,POINT (-94.4709413 41.3307464)
2020_42_HARDIN_EXPEND_SA,2020,42,HARDIN,5295031,505897,726632,1255651,7458987,777524,2371288,617582,1894696,1907300,22810588,3089465,0,25900053,0,5508239,31408292,POINT (-93.2404025 42.3838803)
2005_90_WAPELLO_EXPEND_SA,2005,90,WAPELLO,3189356,1418508,3846946,648136,3095961,573726,1940553,97344,222579,1718000,16751109,625000,,17376109,0,6851487,24227596,POINT (-92.4094499 41.03058450000001)
2018_65_MILLS_EXPEND_SA,2018,65,MILLS,3624724,2132472,441987,1580359,6784732,569647,1632349,0,646991,3620000,21033261,2440771,0,23474032,0,4074896,27548928,POINT (-95.62132670000001 41.0334523)
2006_35_FRANKLIN_EXPEND_SA,2006,35,FRANKLIN,1584158,1327525,1178677,550209,3230000,485619,1530150,0,244653,2191300,12322291,1133000,,13455291,0,3132474,16587765,POINT (-93.262473 42.7325458)
2011_67_MONONA_EXPEND_SA,2011,67,MONONA,1650580,709608,805500,625721,4796085,426881,1457974,0,50640,1190000,11712989,1119298,0,12832287,0,3878402,16710689,POINT (-95.9599235 42.0516663)
2015_9_BREMER_EXPEND_SA,2015,9,BREMER,3846553,2018456,2010748,1639501,4627300,691095,1737645,95241,324680,1785750,18776969,2885323,0,21662292,0,7763187,29425479,POINT (-92.31805480000001 42.7745873)
2009_16_CEDAR_EXPEND_SA,2009,16,CEDAR,2644184,1232858,2619363,1021574,4801800,481806,1365335,4850,0,1452000,15623770,1596668,0,17220438,0,2666077,19886515,POINT (-91.1324125 41.7723207)
2018_59_LUCAS_EXPEND_SA,2018,59,LUCAS,1180505,570372,358643,398214,4076815,327685,1038810,0,182717,2122200,10255961,636475,0,10892436,0,816997,11709433,POINT (-93.3277207 41.0293738)
2014_98_WORTH_EXPEND_SA,2014,98,WORTH,2171615,1099037,386680,886302,3425000,389278,1402504,0,1823163,6222239,17805818,1074747,0,18880565,0,2001991,20882556,POINT (-93.2608476 43.3773984)
2019_48_IOWA_EXPEND_SA,2019,48,IOWA,5154252,1419656,786247,1095107,7047000,725412,3158801,88063,672080,3542099,23688717,1315000,0,25003717,0,6036457,31040174,POINT (-92.065524 41.6863229)
2006_18_CHEROKEE_EXPEND_SA,2006,18,CHEROKEE,1565702,1740112,1148437,477604,3070628,456524,961024,0,0,2018000,11438031,1034000,,12472031,0,3108897,15580928,POINT (-95.6238055 42.7356226)
2007_46_HUMBOLDT_EXPEND_SA,2007,46,HUMBOLDT,1334196,328232,1334561,516203,2780805,341491,940318,0,0,270000,7845806,1032457,,8878263,0,2041247,10919510,POINT (-94.2071868 42.7764686)
2019_20_CLARKE_EXPEND_SA,2019,20,CLARKE,2158568,920315,1111323,334484,3831100,557342,1525390,0,196939,135000,10770461,787904,0,11558365,0,2890688,14449053,POINT (-93.78515790000002 41.0290323)
2009_33_FAYETTE_EXPEND_SA,2009,33,FAYETTE,2775093,550704,2905982,1597413,4861000,628915,1195265,7400,359505,1614450,16495727,1679175,0,18174902,0,1423943,19598845,POINT (-91.8443207 42.8625919)
2017_14_CARROLL_EXPEND_SA,2017,14,CARROLL,3808557,1184699,949897,1105404,5935300,542006,1657115,23540,0,1299283,16505801,2279815,0,18785616,0,5576134,24361750,POINT (-94.8605593 42.0362382)
2005_2_ADAMS_EXPEND_SA,2005,2,ADAMS,719290,426829,475944,350424,2310000,216648,513709,20916,72182,202000,5307942,656193,,5964135,0,1513011,7477146,POINT (-94.6991849 41.02898390000001)
2021_17_CERRO GORDO_EXPEND_SA,2021,17,CERRO GORDO,10017114,6421103,1312780,1937585,7420159,1351902,3925626,0,996113,4615000,37997382,8594587,0,46591969,0,15551981,62143950,POINT (-93.2608184 43.081557700000005)
2016_16_CEDAR_EXPEND_SA,2016,16,CEDAR,3702495,1527219,1200215,1393552,6043600,514547,1673982,6000,0,757000,16818610,2165990,0,18984600,0,3343863,22328463,POINT (-91.1324125 41.7723207)
2022_15_CASS_EXPEND_SA,2022,15,CASS,3559650,523728,295226,616465,7090000,625732,1745378,374491,959688,4984580,20774938,4461680,0,25236618,0,5208326,30444944,POINT (-94.9278266 41.3314876)
2017_55_KOSSUTH_EXPEND_SA,2017,55,KOSSUTH,3153704,323580,909845,1101158,7351855,1030139,2468598,83537,0,2390000,18812416,2821373,0,21633789,0,6555773,28189562,POINT (-94.2067199 43.20413)
2007_68_MONROE_EXPEND_SA,2007,68,MONROE,1150281,759402,944425,284651,2206784,303990,927770,0,414278,516576,7508157,840278,,8348435,0,855584,9204019,POINT (-92.8689877 41.0297826)
2013_58_LOUISA_EXPEND_SA,2013,58,LOUISA,2529438,642980,1336451,4075576,3189395,310054,955438,100000,357190,3354848,16851370,1775211,0,18626581,0,3744448,22371029,POINT (-91.2596184 41.2185073)
2020_37_GREENE_EXPEND_SA,2020,37,GREENE,2565210,601478,346099,714873,6036600,407567,2310451,110000,0,253000,13345278,1613340,0,14958618,0,2884461,17843079,POINT (-94.3968356 42.0362394)
2010_13_CALHOUN_EXPEND_SA,2010,13,CALHOUN,1899384,2749514,1445650,695962,4105145,507960,1099445,9750,0,876000,13388810,1379232,0,14768042,0,2591968,17360010,POINT (-94.6404136 42.385184800000005)
2010_33_FAYETTE_EXPEND_SA,2010,33,FAYETTE,2864629,540649,3185948,1279977,5026580,646120,1194250,7400,363000,768100,15876653,1746216,0,17622869,0,1257823,18880692,POINT (-91.8443207 42.8625919)
2008_16_CEDAR_EXPEND_SA,2008,16,CEDAR,2627530,1508748,2587235,1011414,4937747,456916,1761194,0,1486038,785000,17161822,3128013,0,20289835,0,2601180,22891015,POINT (-91.1324125 41.7723207)
2005_75_PLYMOUTH_EXPEND_SA,2005,75,PLYMOUTH,2165078,273338,1519180,667817,5238000,567384,1567187,0,109153,2184380,14291517,1745000,,16036517,0,5348891,21385408,POINT (-96.2140431 42.7378346)
2022_14_CARROLL_EXPEND_SA,2022,14,CARROLL,5180716,1008526,786435,1252925,7106350,712918,2071127,266500,1118696,1455000,20959193,3266470,0,24225663,0,3444946,27670609,POINT (-94.8605593 42.0362382)
2007_9_BREMER_EXPEND_SA,2007,9,BREMER,2726492,574726,1883793,1231877,3546200,509252,1360024,125000,681049,1085000,13723413,2303336,,16026749,0,6719285,22746034,POINT (-92.31805480000001 42.7745873)
2020_80_RINGGOLD_EXPEND_SA,2020,80,RINGGOLD,1416408,983716,707637,381722,3909993,299044,971351,0,197120,750000,9616991,819777,0,10436768,0,3805010,14241778,POINT (-94.2439719 40.7352023)
2008_11_BUENA VISTA_EXPEND_SA,2008,11,BUENA VISTA,2276206,1124871,1669736,680795,3887525,563352,1259885,34800,1304052,1401750,14202972,1668830,4203975,20075777,0,3320757,23396534,POINT (-95.15114900000002 42.7354936)
2021_68_MONROE_EXPEND_SA,2021,68,MONROE,2354718,852516,325924,527891,3792818,536336,1423910,0,917946,637377,11369436,1458834,0,12828270,0,4164821,16993091,POINT (-92.8689877 41.0297826)
2015_85_STORY_EXPEND_SA,2015,85,STORY,10486069,2368133,6676472,3488012,5771200,1353957,4959320,0,1228349,1948949,38280461,2500000,0,40780461,0,13000058,53780519,POINT (-93.4650448 42.0362415)
2021_21_CLAY_EXPEND_SA,2021,21,CLAY,3519464,842146,354938,1565408,6313828,730655,2848994,0,462742,1750000,18388175,3018205,0,21406380,0,6566870,27973250,POINT (-95.1509194 43.0825804)
2007_95_WINNEBAGO_EXPEND_SA,2007,95,WINNEBAGO,1119595,405032,1298380,522836,2919000,353293,745866,146043,0,778500,8288545,1332256,,9620801,0,1328143,10948944,POINT (-93.7341955 43.37756780000001)
2017_19_CHICKASAW_EXPEND_SA,2017,19,CHICKASAW,2298785,1804304,825365,719532,5158330,452127,1617658,4500,0,365330,13245931,2151224,0,15397155,0,4979479,20376634,POINT (-92.3176637 43.06004140000001)
2007_36_FREMONT_EXPEND_SA,2007,36,FREMONT,1705829,183287,1345472,592091,3331000,396792,956407,2800,0,246000,8759678,834574,,9594252,0,2516249,12110501,POINT (-95.6046765 40.7455892)
2009_57_LINN_EXPEND_SA,2009,57,LINN,21602246,15636893,32003183,6029929,10921836,3748690,10835620,19054,1254000,2587500,104638951,12389105,0,117028056,0,19328598,136356654,POINT (-91.5989646 42.0789478)
2005_7_BLACK HAWK_EXPEND_SA,2005,7,BLACK HAWK,14775624,9748801,17972736,2429617,4284928,1453652,5134416,0,2836697,857537,59494008,1624082,,61118090,0,10092426,71210516,POINT (-92.3088197 42.4700957)
2014_30_DICKINSON_EXPEND_SA,2014,30,DICKINSON,2394873,600522,797657,2806062,4776089,734700,2092110,409120,1717519,2023000,18351652,3316981,0,21668633,0,7910619,29579252,POINT (-95.1508301 43.3779848)
2007_51_JEFFERSON_EXPEND_SA,2007,51,JEFFERSON,2440086,524660,1241651,533271,2480000,382347,844550,0,157023,747000,9350588,674994,,10025582,0,2892041,12917623,POINT (-91.9488774 41.0317596)
2005_61_MADISON_EXPEND_SA,2005,61,MADISON,1607268,533308,1051650,457057,3620371,359906,736670,0,122664,1073042,9561936,1070865,,10632801,0,2065708,12698509,POINT (-94.01556190000001 41.33071420000001)
2008_84_SIOUX_EXPEND_SA,2008,84,SIOUX,3363821,2206907,2707193,817702,5457100,761780,1901487,48700,478467,2431750,20174907,1713476,0,21888383,0,3949789,25838172,POINT (-96.1778827 43.0826174)
2006_19_CHICKASAW_EXPEND_SA,2006,19,CHICKASAW,1169488,1312428,1100720,493988,3386600,456934,1017760,0,0,507600,9445518,1332142,,10777660,0,4696962,15474622,POINT (-92.3176637 43.06004140000001)
2010_18_CHEROKEE_EXPEND_SA,2010,18,CHEROKEE,1625982,349549,1418407,621450,3973997,331489,1414551,0,0,1615000,11350425,1371000,0,12721425,0,2641037,15362462,POINT (-95.6238055 42.7356226)
2014_52_JOHNSON_EXPEND_SA,2014,52,JOHNSON,22275358,8910290,14039463,3751808,8473632,2284326,7837712,3000,11704537,6381658,85661784,15015252,0,100677036,0,24016604,124693640,POINT (-91.5880849 41.6715511)
2009_44_HENRY_EXPEND_SA,2009,44,HENRY,2894914,766165,2790677,935078,3936500,544471,1083574,42100,151100,739050,13883629,937944,0,14821573,0,3657226,18478799,POINT (-91.5445241 40.9879383)
2011_85_STORY_EXPEND_SA,2011,85,STORY,9405414,2152121,8721375,2454829,5090500,1186707,4593041,0,1923683,4595000,40122670,2075000,0,42197670,0,6063558,48261228,POINT (-93.4650448 42.0362415)
2007_73_PAGE_EXPEND_SA,2007,73,PAGE,1461093,639041,1604842,260345,3925000,373364,795870,2500,0,1340000,10402055,721381,,11123436,0,1925087,13048523,POINT (-95.1501747 40.7391444)
2010_35_FRANKLIN_EXPEND_SA,2010,35,FRANKLIN,1521704,1778833,1121766,707514,4292000,431846,1995916,0,408805,861498,13119882,1577768,0,14697650,0,2793258,17490908,POINT (-93.262473 42.7325458)
2022_9_BREMER_EXPEND_SA,2022,9,BREMER,5006973,749830,927695,1721463,5799965,851127,2112068,63700,171600,5410000,22814421,3273090,0,26087511,0,11149165,37236676,POINT (-92.31805480000001 42.7745873)
2019_53_JONES_EXPEND_SA,2019,53,JONES,3092969,786569,878666,1809143,6624581,754827,1936031,89107,458457,3188583,19618933,2262427,0,21881360,0,6673292,28554652,POINT (-91.1314352 42.1212397)
2011_68_MONROE_EXPEND_SA,2011,68,MONROE,1336123,926728,941432,342773,2738896,383401,1017724,0,458096,834500,8979673,914713,0,9894386,0,982611,10876997,POINT (-92.8689877 41.0297826)
2010_52_JOHNSON_EXPEND_SA,2010,52,JOHNSON,30165938,8311221,14117902,3264027,6855646,2208433,7090833,0,4145356,7918090,84077446,25009395,0,109086841,0,18123803,127210644,POINT (-91.5880849 41.6715511)
2013_2_ADAMS_EXPEND_SA,2013,2,ADAMS,1082508,290054,575529,649559,2798300,254005,746878,32266,460280,35500,6924879,837865,0,7762744,0,2453146,10215890,POINT (-94.6991849 41.02898390000001)
2014_35_FRANKLIN_EXPEND_SA,2014,35,FRANKLIN,1680506,2296944,534156,881331,4646503,499184,1694824,0,1149435,662362,14045245,1615104,0,15660349,0,4188598,19848947,POINT (-93.262473 42.7325458)
2005_86_TAMA_EXPEND_SA,2005,86,TAMA,2587259,1249098,1735085,869883,5715768,479662,1128406,3475,0,2352238,16120874,1875873,,17996747,0,1381448,19378195,POINT (-92.5325425 42.07981170000001)
2018_20_CLARKE_EXPEND_SA,2018,20,CLARKE,2068338,1041960,245789,344112,3791100,516800,1461554,0,208060,680000,10357713,699518,0,11057231,0,2064208,13121439,POINT (-93.78515790000002 41.0290323)
2007_4_APPANOOSE_EXPEND_SA,2007,4,APPANOOSE,1659527,772126,1417856,346499,3176000,328229,770198,0,26440,578000,9074875,486360,,9561235,0,4022152,13583387,POINT (-92.8686104 40.7431635)
2017_12_BUTLER_EXPEND_SA,2017,12,BUTLER,2450781,1454258,556007,1037605,5430000,652760,1808022,2500,590740,1489903,15472576,2268860,0,17741436,0,4410165,22151601,POINT (-92.7901934 42.7315661)
2016_65_MILLS_EXPEND_SA,2016,65,MILLS,3422814,1743706,491568,1400501,5525230,545679,1435397,0,537933,560000,15662828,2483785,0,18146613,0,3188581,21335194,POINT (-95.62132670000001 41.0334523)
2012_69_MONTGOMERY_EXPEND_SA,2012,69,MONTGOMERY,2028170,682198,1255218,377430,3048900,421136,891681,200,404988,5744534,14854455,1022145,0,15876600,0,2848353,18724953,POINT (-95.1563758 41.03014)
2013_19_CHICKASAW_EXPEND_SA,2013,19,CHICKASAW,1610270,1611692,1292733,576850,4390190,445082,1333471,2100,0,934915,12197303,2332022,0,14529325,0,4876458,19405783,POINT (-92.3176637 43.06004140000001)
2018_52_JOHNSON_EXPEND_SA,2018,52,JOHNSON,24595247,10833937,8557318,5219292,10248973,2698323,9621530,6090,18884658,19752121,110417489,18422148,0,128839637,0,20932807,149772444,POINT (-91.5880849 41.6715511)
2008_85_STORY_EXPEND_SA,2008,85,STORY,8396474,1905727,9116173,2571806,4672070,1731660,4386219,0,1205388,788660,34774177,1800000,0,36574177,0,5615725,42189902,POINT (-93.4650448 42.0362415)
2019_85_STORY_EXPEND_SA,2019,85,STORY,12136760,2540695,1979364,3982840,6800300,1248592,5925726,0,1518680,3671142,39804099,3093350,0,42897449,0,17739938,60637387,POINT (-93.4650448 42.0362415)
2022_26_DAVIS_EXPEND_SA,2022,26,DAVIS,1983259,471205,451243,481794,4726999,492838,1213140,40539,400205,1800000,12061222,1144414,0,13205636,0,1212523,14418159,POINT (-92.4097173 40.7476891)
2007_23_CLINTON_EXPEND_SA,2007,23,CLINTON,5377528,1458616,7695804,1411968,4554172,950078,2564156,354400,0,511900,24878622,883244,,25761866,0,3984313,29746179,POINT (-90.5319724 41.8980358)
2008_70_MUSCATINE_EXPEND_SA,2008,70,MUSCATINE,6288645,1501159,5176228,881226,4533000,757543,2242949,30000,3881126,1993000,27284876,657533,0,27942409,0,3996469,31938878,POINT (-91.1127562 41.4839221)
2018_25_DALLAS_EXPEND_SA,2018,25,DALLAS,12638052,3789881,2760599,4733259,8548733,2343088,1690328,51100,2481635,4199520,43236195,6170229,0,49406424,0,18003640,67410064,POINT (-94.0397374 41.6848862)
2010_40_HAMILTON_EXPEND_SA,2010,40,HAMILTON,2571816,2070783,2406006,1384619,4198000,450386,1308532,0,1509947,2149621,18049710,2281862,0,20331572,0,3356867,23688439,POINT (-93.7068085 42.3837722)
2006_4_APPANOOSE_EXPEND_SA,2006,4,APPANOOSE,1575827,761869,1330982,358584,3566000,304164,723887,0,33440,1500000,10154753,536360,,10691113,0,4970959,15662072,POINT (-92.8686104 40.7431635)
2015_78_POTTAWATTAMIE_EXPEND_SA,2015,78,POTTAWATTAMIE,27145798,5679700,9656862,7838289,12020856,2330353,6773972,0,3938971,2150000,77534801,5910000,0,83444801,0,13097726,96542527,POINT (-95.5423935 41.3366123)
2022_54_KEOKUK_EXPEND_SA,2022,54,KEOKUK,1377841,785068,436481,401826,5884000,452966,2078202,0,199160,435000,12050544,2238160,0,14288704,0,3130201,17418905,POINT (-92.1786426 41.336465)
2022_86_TAMA_EXPEND_SA,2022,86,TAMA,4760432,1869595,658347,1036288,9896773,658414,5044434,25500,931785,3472000,28353568,3037979,0,31391547,0,5679770,37071317,POINT (-92.5325425 42.07981170000001)
2012_22_CLAYTON_EXPEND_SA,2012,22,CLAYTON,2561947,702600,2128541,1242404,6379372,665780,1293095,1300,253804,1417500,16646343,1400000,0,18046343,0,5354032,23400375,POINT (-91.34143280000002 42.8447493)
2021_53_JONES_EXPEND_SA,2021,53,JONES,3411325,854773,971465,3353891,7139295,838122,1986880,113763,0,1676977,20346491,2586172,0,22932663,0,5690206,28622869,POINT (-91.1314352 42.1212397)
2015_58_LOUISA_EXPEND_SA,2015,58,LOUISA,2719379,650964,539942,4488623,3161758,295399,1118509,0,361472,3223598,16559644,1985832,0,18545476,0,5566261,24111737,POINT (-91.2596184 41.2185073)
2022_48_IOWA_EXPEND_SA,2022,48,IOWA,6050223,1493459,581176,1155727,7265028,925876,6532180,115500,777057,2000180,26896406,1315000,0,28211406,0,7065092,35276498,POINT (-92.065524 41.6863229)
2013_7_BLACK HAWK_EXPEND_SA,2013,7,BLACK HAWK,17969495,8216333,7344615,7053057,5768875,1707763,5345284,0,5672703,1758146,60836271,2653603,0,63489874,0,20911093,84400967,POINT (-92.3088197 42.4700957)
2015_68_MONROE_EXPEND_SA,2015,68,MONROE,1777974,847233,459702,769119,2593213,456894,1267620,0,877692,4940000,13989447,1535157,0,15524604,0,2233801,17758405,POINT (-92.8689877 41.0297826)
2016_75_PLYMOUTH_EXPEND_SA,2016,75,PLYMOUTH,3719174,399549,534483,1032437,7969000,855448,3619782,0,1737750,2741000,22608623,4038775,0,26647398,0,4599449,31246847,POINT (-96.2140431 42.7378346)
2017_87_TAYLOR_EXPEND_SA,2017,87,TAYLOR,1689009,1075330,96307,264537,4109000,364347,765317,0,953605,1150000,10467452,796290,0,11263742,0,3023512,14287254,POINT (-94.6964148 40.73743240000001)
2008_38_GRUNDY_EXPEND_SA,2008,38,GRUNDY,1638317,487059,1354281,1218163,3673820,387333,1587829,0,102378,1226270,11675450,1139600,0,12815050,0,3806462,16621512,POINT (-92.7914177 42.4018651)
2019_2_ADAMS_EXPEND_SA,2019,2,ADAMS,1497408,222802,178811,783392,3580000,348064,854208,0,872529,155000,8492214,1036711,0,9528925,0,2309564,11838489,POINT (-94.6991849 41.02898390000001)
2022_41_HANCOCK_EXPEND_SA,2022,41,HANCOCK,2308735,487445,201970,824061,6603502,643478,2098636,7500,0,1525000,14700327,2728600,0,17428927,0,5963087,23392014,POINT (-93.7342723 43.0818861)
2014_20_CLARKE_EXPEND_SA,2014,20,CLARKE,1633601,1017370,443262,260275,2603047,427703,942749,0,398916,525014,8251937,643141,0,8895078,0,2649364,11544442,POINT (-93.78515790000002 41.0290323)
2014_67_MONONA_EXPEND_SA,2014,67,MONONA,1711160,547630,436500,672817,4979614,494493,1444745,0,47678,681000,11015637,1488139,0,12503776,0,3973319,16477095,POINT (-95.9599235 42.0516663)
2017_36_FREMONT_EXPEND_SA,2017,36,FREMONT,2658455,290868,384516,653264,4093000,482908,1433318,4000,459110,455000,10914439,1312780,0,12227219,0,4608549,16835768,POINT (-95.6046765 40.7455892)
2014_4_APPANOOSE_EXPEND_SA,2014,4,APPANOOSE,2139182,826541,576200,673214,3569980,518287,1060504,0,192937,750000,10306845,737215,0,11044060,0,5356497,16400557,POINT (-92.8686104 40.7431635)
2012_54_KEOKUK_EXPEND_SA,2012,54,KEOKUK,1014985,680139,1050219,353186,4154000,352960,2264172,0,0,550000,10419661,1200000,0,11619661,0,4643038,16262699,POINT (-92.1786426 41.336465)
2016_3_ALLAMAKEE_EXPEND_SA,2016,3,ALLAMAKEE,2156314,720501,957775,2666549,5451441,540559,1301259,162500,87500,1650000,15694398,1705203,0,17399601,0,2063324,19462925,POINT (-91.3780923 43.2842838)
2013_34_FLOYD_EXPEND_SA,2013,34,FLOYD,2269897,1651923,847443,660602,4854964,605107,1284445,0,381228,1033000,13588609,1028517,0,14617126,0,6151380,20768506,POINT (-92.78900330000002 43.0599208)
2018_57_LINN_EXPEND_SA,2018,57,LINN,27818832,15736625,14413895,7789968,13216396,4626125,15773145,0,1917734,10074000,111366720,18282480,0,129649200,0,39902097,169551297,POINT (-91.5989646 42.0789478)
2015_32_EMMET_EXPEND_SA,2015,32,EMMET,1781277,756086,971036,491655,3382071,469875,1230036,10565,0,16000,9108601,959615,0,10068216,0,2144354,12212570,POINT (-94.6784803 43.37802250000001)
2012_86_TAMA_EXPEND_SA,2012,86,TAMA,3281805,1509957,1913644,955960,7280008,508804,1187016,7750,0,1448774,18093718,2088675,0,20182393,0,1232982,21415375,POINT (-92.5325425 42.07981170000001)
2015_53_JONES_EXPEND_SA,2015,53,JONES,2492450,806511,1513701,1071577,6478690,655421,1606331,140541,500,724226,15489948,1935000,0,17424948,0,4105487,21530435,POINT (-91.1314352 42.1212397)
2014_62_MAHASKA_EXPEND_SA,2014,62,MAHASKA,3176845,856528,1334433,813601,5345000,651349,1371995,975000,8490,200000,14733241,1964191,0,16697432,0,7733356,24430788,POINT (-92.6409094 41.3352035)
2020_35_FRANKLIN_EXPEND_SA,2020,35,FRANKLIN,1960205,1635045,391448,1091199,5905000,551875,2069734,0,2763145,560000,16927651,3215805,0,20143456,0,6972456,27115912,POINT (-93.262473 42.7325458)
2018_69_MONTGOMERY_EXPEND_SA,2018,69,MONTGOMERY,3069632,608064,235382,471863,4559036,512884,1946696,200,556663,685880,12646300,1080000,0,13726300,0,4073851,17800151,POINT (-95.1563758 41.03014)
2020_96_WINNESHIEK_EXPEND_SA,2020,96,WINNESHIEK,3742281,1429905,808119,2925100,8088000,715831,2783327,4500,0,3805000,24302063,2844307,0,27146370,0,6787427,33933797,POINT (-91.8437074 43.2906746)
2017_68_MONROE_EXPEND_SA,2017,68,MONROE,2001928,842641,663520,753737,4136939,461779,1365352,0,774200,1212500,12212596,2099640,0,14312236,0,1917806,16230042,POINT (-92.8689877 41.0297826)
2008_6_BENTON_EXPEND_SA,2008,6,BENTON,2854293,733421,1745844,1475417,5903870,595929,1537039,0,0,1834132,16679945,2388829,0,19068774,0,4414263,23483037,POINT (-92.0656912 42.0801864)
2007_63_MARION_EXPEND_SA,2007,63,MARION,2547867,1884020,2574536,1117459,5650309,639038,1994431,0,467000,4540000,21414660,1567860,,22982520,0,4307560,27290080,POINT (-93.0994367 41.3344515)
2016_35_FRANKLIN_EXPEND_SA,2016,35,FRANKLIN,1800362,2427508,130388,921030,4976000,510038,1950248,5886,2021363,933000,15675823,2000682,0,17676505,0,5653574,23330079,POINT (-93.262473 42.7325458)
2013_71_O'BRIEN_EXPEND_SA,2013,71,O'BRIEN,2956996,449951,1937850,800398,4434175,563710,1060155,9000,993091,1249000,14454326,1851914,0,16306240,0,3097311,19403551,POINT (-95.6248784 43.0837527)
2008_53_JONES_EXPEND_SA,2008,53,JONES,1989322,823009,2497372,877807,4687803,526277,1138301,169978,37138,2276000,15023007,1545500,0,16568507,0,2566251,19134758,POINT (-91.1314352 42.1212397)
2020_86_TAMA_EXPEND_SA,2020,86,TAMA,3929977,1696068,911106,975268,8441351,654801,1852038,39500,965619,7534228,26999956,2914183,0,29914139,0,4214975,34129114,POINT (-92.5325425 42.07981170000001)
2016_86_TAMA_EXPEND_SA,2016,86,TAMA,3664397,1608221,1040163,1114261,7453747,553622,1459876,36750,250735,3133904,20315676,2150000,0,22465676,0,4548039,27013715,POINT (-92.5325425 42.07981170000001)
2005_29_DES MOINES_EXPEND_SA,2005,29,DES MOINES,4425640,1706416,5347445,1199116,3570260,691867,4373880,0,40000,1584100,22938724,1395581,,24334305,0,2812851,27147156,POINT (-91.1814707 40.9231829)
2021_93_WAYNE_EXPEND_SA,2021,93,WAYNE,2265713,1133682,265971,371879,4291900,342561,1153180,20000,263414,510000,10618300,784700,0,11403000,0,3897252,15300252,POINT (-93.3273639 40.73947020000001)
2005_39_GUTHRIE_EXPEND_SA,2005,39,GUTHRIE,863102,1052922,1157300,1047432,3714679,357744,893990,2500,485000,485000,10059669,873000,,10932669,0,3029709,13962378,POINT (-94.501055 41.6837548)
2017_30_DICKINSON_EXPEND_SA,2017,30,DICKINSON,2736314,540674,546702,2355079,5773000,861958,2218583,207000,1708694,2948857,19896861,3788277,0,23685138,0,9866278,33551416,POINT (-95.1508301 43.3779848)
2011_5_AUDUBON_EXPEND_SA,2011,5,AUDUBON,1088160,616930,997157,451390,2934862,328736,717248,300,83110,67719,7285612,699102,0,7984714,0,2278539,10263253,POINT (-94.9058222 41.6845893)
2006_62_MAHASKA_EXPEND_SA,2006,62,MAHASKA,2383945,848502,2135528,587414,4097750,681552,1142457,669300,0,614000,13160448,1351313,,14511761,0,11554086,26065847,POINT (-92.6409094 41.3352035)
2020_18_CHEROKEE_EXPEND_SA,2020,18,CHEROKEE,2615973,392615,441292,1108022,5513828,623400,1590725,100000,0,2810000,15195855,2161170,0,17357025,0,6423902,23780927,POINT (-95.6238055 42.7356226)
2022_69_MONTGOMERY_EXPEND_SA,2022,69,MONTGOMERY,3749965,559571,228091,417931,4585294,500382,1286581,0,1089866,1200000,13617681,1096000,0,14713681,0,3019325,17733006,POINT (-95.1563758 41.03014)
2013_29_DES MOINES_EXPEND_SA,2013,29,DES MOINES,6412340,1612873,4967884,1709138,5060903,1044216,3427079,0,681960,874000,25790393,1725196,0,27515589,0,3440312,30955901,POINT (-91.1814707 40.9231829)
2010_67_MONONA_EXPEND_SA,2010,67,MONONA,1671550,769724,943850,608998,4183033,431437,1464145,0,51161,775000,10898898,1079414,0,11978312,0,4725628,16703940,POINT (-95.9599235 42.0516663)
2021_83_SHELBY_EXPEND_SA,2021,83,SHELBY,2769819,604761,290700,512446,6195437,439336,1581804,12000,100,916900,13323303,3901212,0,17224515,0,3105808,20330323,POINT (-95.31021130000002 41.6850926)
2008_96_WINNESHIEK_EXPEND_SA,2008,96,WINNESHIEK,1963081,1646020,2646362,1382064,5118947,315203,1322301,6000,563441,4203869,19167288,1907201,0,21074489,0,3148473,24222962,POINT (-91.8437074 43.2906746)
2020_3_ALLAMAKEE_EXPEND_SA,2020,3,ALLAMAKEE,2926740,710319,726108,1261078,6554342,585549,1220539,14500,420500,1450000,15869675,2071329,0,17941004,0,2586457,20527461,POINT (-91.3780923 43.2842838)
2008_1_ADAIR_EXPEND_SA,2008,1,ADAIR,910196,251692,789240,323475,3471333,218535,665197,0,210973,486000,7326641,1064371,0,8391012,0,2197578,10588590,POINT (-94.4709413 41.3307464)
2005_71_O'BRIEN_EXPEND_SA,2005,71,O'BRIEN,2125027,428996,1466374,531894,2726700,395703,741104,11000,304054,1339500,10070352,1360982,,11431334,0,2763075,14194409,POINT (-95.6248784 43.0837527)
2009_29_DES MOINES_EXPEND_SA,2009,29,DES MOINES,6424588,2782663,4597874,2423493,4083494,1016827,3271051,0,578563,3062635,28241188,1643974,0,29885162,0,4908114,34793276,POINT (-91.1814707 40.9231829)
2006_94_WEBSTER_EXPEND_SA,2006,94,WEBSTER,4272315,2153497,3930000,903430,5600000,658848,2283725,250000,386089,3000000,23437904,1975000,,25412904,0,7010621,32423525,POINT (-94.18178810000002 42.4279662)
2009_12_BUTLER_EXPEND_SA,2009,12,BUTLER,1712547,1525810,1498040,726887,4280000,431332,1331418,5000,38763,1459500,13009297,1373950,0,14383247,0,3203626,17586873,POINT (-92.7901934 42.7315661)
2012_1_ADAIR_EXPEND_SA,2012,1,ADAIR,1276910,292281,758034,455575,3709926,297160,738159,0,202250,3100380,10830675,2034625,0,12865300,0,5271678,18136978,POINT (-94.4709413 41.3307464)
2011_37_GREENE_EXPEND_SA,2011,37,GREENE,1327968,387363,1386235,880525,3966805,331168,1393119,50000,0,233000,9956183,1158500,0,11114683,0,2569155,13683838,POINT (-94.3968356 42.0362394)
2009_34_FLOYD_EXPEND_SA,2009,34,FLOYD,2188957,1313058,2145302,714402,4590344,643617,1208725,0,177911,2043347,15025663,899418,0,15925081,0,4523337,20448418,POINT (-92.78900330000002 43.0599208)
2007_78_POTTAWATTAMIE_EXPEND_SA,2007,78,POTTAWATTAMIE,15430815,3068374,7896071,7067592,10655010,1582106,5160780,0,1655019,5732000,58247767,4580237,,62828004,0,6869016,69697020,POINT (-95.5423935 41.3366123)
2012_96_WINNESHIEK_EXPEND_SA,2012,96,WINNESHIEK,2401860,1539521,3244376,1616162,5532200,497125,1860084,6000,0,943110,17640438,1909146,0,19549584,0,3074744,22624328,POINT (-91.8437074 43.2906746)
2005_22_CLAYTON_EXPEND_SA,2005,22,CLAYTON,1765116,476954,1623194,892466,5375950,400237,1128263,1300,0,1100775,12764255,1747000,,14511255,0,1830488,16341743,POINT (-91.34143280000002 42.8447493)
2021_36_FREMONT_EXPEND_SA,2021,36,FREMONT,3079864,315780,174825,455064,5300000,505663,2031262,10000,702563,2521000,15096021,1356480,0,16452501,0,4235740,20688241,POINT (-95.6046765 40.7455892)
2018_84_SIOUX_EXPEND_SA,2018,84,SIOUX,4605826,1486235,613507,1670049,7022715,1067907,2548589,161000,1078785,4327050,24581663,3004000,0,27585663,0,11129453,38715116,POINT (-96.1778827 43.0826174)
2006_39_GUTHRIE_EXPEND_SA,2006,39,GUTHRIE,871849,1082103,1135000,899227,3263159,442646,882868,0,420000,235000,9231852,890000,,10121852,0,4144157,14266009,POINT (-94.501055 41.6837548)
2006_67_MONONA_EXPEND_SA,2006,67,MONONA,1389074,713357,797664,434097,3466203,553147,1366921,0,0,2350000,11070463,615000,,11685463,0,2215860,13901323,POINT (-95.9599235 42.0516663)
2013_24_CRAWFORD_EXPEND_SA,2013,24,CRAWFORD,1995005,2608800,2382594,983513,6768500,565863,1348992,0,245000,339000,17237267,2298000,0,19535267,0,5407556,24942823,POINT (-95.3819678 42.0372125)
2012_37_GREENE_EXPEND_SA,2012,37,GREENE,1367568,464757,1241680,857587,3984779,351897,1435021,50000,0,45000,9798289,1201000,0,10999289,0,2877872,13877161,POINT (-94.3968356 42.0362394)
2005_34_FLOYD_EXPEND_SA,2005,34,FLOYD,1691267,913528,1562425,524712,3475350,478640,821331,0,97135,582000,10146388,1021072,,11167460,0,4581299,15748759,POINT (-92.78900330000002 43.0599208)
2017_51_JEFFERSON_EXPEND_SA,2017,51,JEFFERSON,3031742,902753,645034,715848,4021909,530237,1048776,10000,350983,3025000,14282282,1294281,0,15576563,0,3381216,18957779,POINT (-91.9488774 41.0317596)
2020_76_POCAHONTAS_EXPEND_SA,2020,76,POCAHONTAS,2462424,1676372,382632,1112690,4888569,456616,1638227,110385,0,1238203,13966118,1834433,0,15800551,0,11276285,27076836,POINT (-94.67874660000001 42.73413510000001)
2005_93_WAYNE_EXPEND_SA,2005,93,WAYNE,753245,523854,746581,288461,2185700,217138,608876,54200,0,281200,5659255,479000,,6138255,0,523264,6661519,POINT (-93.3273639 40.73947020000001)
2019_38_GRUNDY_EXPEND_SA,2019,38,GRUNDY,2259119,533086,696706,1110500,5365824,472077,1915415,0,1830678,2215836,16399241,1992673,0,18391914,0,3314292,21706206,POINT (-92.7914177 42.4018651)
2014_26_DAVIS_EXPEND_SA,2014,26,DAVIS,1159310,364152,373300,326131,3504714,355932,895726,25000,176000,515000,7695265,769103,0,8464368,0,2085857,10550225,POINT (-92.4097173 40.7476891)
2009_72_OSCEOLA_EXPEND_SA,2009,72,OSCEOLA,1029412,163350,630750,421953,2276171,243924,755711,0,303800,920000,6745071,887189,0,7632260,0,1770966,9403226,POINT (-95.6236852 43.3785704)
2007_32_EMMET_EXPEND_SA,2007,32,EMMET,1264421,593527,1689318,393922,2536779,321349,869818,0,15300,120752,7805186,588971,,8394157,0,1279961,9674118,POINT (-94.6784803 43.37802250000001)
2013_56_LEE_EXPEND_SA,2013,56,LEE,4397227,4087812,5410122,1325290,4823765,983968,2202794,20000,815526,740130,24806634,1425000,0,26231634,0,6975972,33207606,POINT (-91.479264 40.6419764)
2010_72_OSCEOLA_EXPEND_SA,2010,72,OSCEOLA,1053773,212938,670200,415626,2355000,247876,716134,0,287226,400000,6358773,989337,0,7348110,0,1716279,9064389,POINT (-95.6236852 43.3785704)
2009_89_VAN BUREN_EXPEND_SA,2009,89,VAN BUREN,1012429,432575,581531,411284,2445600,285563,575765,3350,0,878500,6626597,507188,0,7133785,0,1583337,8717122,POINT (-91.9499871 40.7532294)
2015_43_HARRISON_EXPEND_SA,2015,43,HARRISON,2629208,1637229,1952289,1060913,6005000,680957,1334829,0,0,380000,15680425,2011500,0,17691925,0,7357116,25049041,POINT (-95.8169209 41.6828528)
2007_55_KOSSUTH_EXPEND_SA,2007,55,KOSSUTH,2430033,422374,1920342,724275,5425000,599513,1638745,61523,0,2001400,15223205,2351767,,17574972,0,4797320,22372292,POINT (-94.2067199 43.20413)
2021_19_CHICKASAW_EXPEND_SA,2021,19,CHICKASAW,2529378,1551660,360150,701307,6225960,521323,1773507,0,520655,4203778,18387718,1888863,0,20276581,0,6717731,26994312,POINT (-92.3176637 43.06004140000001)
2006_99_WRIGHT_EXPEND_SA,2006,99,WRIGHT,1522751,2994727,1593215,1023516,3510000,575785,1062005,23227,169212,810000,13284438,1119643,,14404081,0,2794505,17198586,POINT (-93.7351465 42.7331189)
2008_65_MILLS_EXPEND_SA,2008,65,MILLS,2227837,1715165,1556608,941794,3899700,459795,985619,0,0,375000,12161518,1400000,0,13561518,0,4279742,17841260,POINT (-95.62132670000001 41.0334523)
2018_79_POWESHIEK_EXPEND_SA,2018,79,POWESHIEK,3146611,351472,413479,624664,6884187,726025,1306846,125000,744108,2301849,16624241,2566255,0,19190496,0,6909245,26099741,POINT (-92.53146840000001 41.6864422)
2005_66_MITCHELL_EXPEND_SA,2005,66,MITCHELL,1115712,733056,1523799,566737,2510000,254989,691026,500,208265,150000,7754084,1029000,,8783084,0,1661822,10444906,POINT (-92.7890315 43.3564124)
2011_32_EMMET_EXPEND_SA,2011,32,EMMET,1529124,683218,1717414,445507,2676292,398470,1155923,0,15300,37497,8658745,730420,0,9389165,0,1199347,10588512,POINT (-94.6784803 43.37802250000001)
2013_88_UNION_EXPEND_SA,2013,88,UNION,1582300,448546,1485958,473023,4163000,443364,953191,0,1791250,1471116,12811748,764960,0,13576708,0,2727368,16304076,POINT (-94.2423792 41.0277304)
2013_61_MADISON_EXPEND_SA,2013,61,MADISON,2468681,758183,1116550,667816,4448311,470765,949512,0,97615,607140,11584573,1613403,0,13197976,0,2781187,15979163,POINT (-94.01556190000001 41.33071420000001)
2020_71_O'BRIEN_EXPEND_SA,2020,71,O'BRIEN,3689603,466938,207015,1026832,4797070,681092,1470649,49800,0,1619000,14007999,3792112,0,17800111,0,7082487,24882598,POINT (-95.6248784 43.0837527)
2009_40_HAMILTON_EXPEND_SA,2009,40,HAMILTON,2462651,2156652,2365047,2089450,4275800,436350,1286677,0,415657,1720667,17208951,2275309,0,19484260,0,3457090,22941350,POINT (-93.7068085 42.3837722)
2005_98_WORTH_EXPEND_SA,2005,98,WORTH,1202467,1182307,884880,471295,2270000,254047,732890,0,182056,831000,8010942,679000,,8689942,0,2459864,11149806,POINT (-93.2608476 43.3773984)
2008_33_FAYETTE_EXPEND_SA,2008,33,FAYETTE,2528546,549368,2597389,1299871,4571458,569712,1154652,7400,355425,832100,14465921,1542228,0,16008149,0,1368911,17377060,POINT (-91.8443207 42.8625919)
2016_90_WAPELLO_EXPEND_SA,2016,90,WAPELLO,4090018,1297795,5188151,868467,4324690,801314,3081287,142263,785676,3915475,24495136,1150000,0,25645136,0,7084557,32729693,POINT (-92.4094499 41.03058450000001)
2018_10_BUCHANAN_EXPEND_SA,2018,10,BUCHANAN,3608473,644816,1156309,1167683,5827600,754245,1624513,77875,536773,702000,16100287,2691477,0,18791764,0,6911605,25703369,POINT (-91.8378392 42.4707777)
2011_72_OSCEOLA_EXPEND_SA,2011,72,OSCEOLA,1062190,248344,672780,340013,2455000,263945,693884,69781,457300,300000,6563237,1113438,0,7676675,0,2087824,9764499,POINT (-95.6236852 43.3785704)
2022_5_AUDUBON_EXPEND_SA,2022,5,AUDUBON,1737372,455430,157624,633712,4564649,577813,1024666,100,613275,8674600,18439241,8404175,0,26843416,0,4424583,31267999,POINT (-94.9058222 41.6845893)
2019_72_OSCEOLA_EXPEND_SA,2019,72,OSCEOLA,1694205,238727,60640,1589965,5178599,281031,1197135,169850,604971,40000,11055123,1646891,0,12702014,0,6072212,18774226,POINT (-95.6236852 43.3785704)
2021_41_HANCOCK_EXPEND_SA,2021,41,HANCOCK,2225750,447484,321360,739020,6518978,619422,1803078,20500,0,792500,13488092,2538520,0,16026612,0,4408244,20434856,POINT (-93.7342723 43.0818861)
2010_89_VAN BUREN_EXPEND_SA,2010,89,VAN BUREN,1038793,483400,558770,384932,2690000,293747,563233,3350,0,667701,6683926,536785,0,7220711,0,1811473,9032184,POINT (-91.9499871 40.7532294)
2010_28_DELAWARE_EXPEND_SA,2010,28,DELAWARE,1888475,682372,2803114,800953,3923645,599569,1213470,16550,96000,1712123,13736271,1789702,0,15525973,0,1539491,17065464,POINT (-91.3673502 42.471211)
2013_39_GUTHRIE_EXPEND_SA,2013,39,GUTHRIE,1141786,1237593,1064437,1220820,4524000,366458,953067,15000,46800,1338000,11907961,1424717,0,13332678,0,3000217,16332895,POINT (-94.501055 41.6837548)
2013_98_WORTH_EXPEND_SA,2013,98,WORTH,2046732,1135315,900018,979278,3119507,375749,1371853,0,1569177,6552445,18050074,1040630,0,19090704,0,8748028,27838732,POINT (-93.2608476 43.3773984)
2016_71_O'BRIEN_EXPEND_SA,2016,71,O'BRIEN,3313187,448549,841538,912663,4575000,609668,1298164,9500,276585,800000,13084854,1870041,0,14954895,0,4904359,19859254,POINT (-95.6248784 43.0837527)
2009_66_MITCHELL_EXPEND_SA,2009,66,MITCHELL,1520149,975136,1657811,1327905,3353000,273738,944313,250,624888,200000,10877190,1352187,0,12229377,0,1766672,13996049,POINT (-92.7890315 43.3564124)
2009_98_WORTH_EXPEND_SA,2009,98,WORTH,1492034,1142713,935400,921896,2955356,346179,1012019,0,439745,571138,9816480,783369,0,10599849,0,2542009,13141858,POINT (-93.2608476 43.3773984)
2017_23_CLINTON_EXPEND_SA,2017,23,CLINTON,7821282,1652005,2564878,1861331,5312154,1206722,3850358,873215,1570544,1835104,28547593,1766661,0,30314254,0,6194587,36508841,POINT (-90.5319724 41.8980358)
2021_73_PAGE_EXPEND_SA,2021,73,PAGE,3020189,588184,381225,527570,4816000,678198,2070562,8000,431641,2475000,14996569,1512959,0,16509528,0,5909262,22418790,POINT (-95.1501747 40.7391444)
2015_90_WAPELLO_EXPEND_SA,2015,90,WAPELLO,3972309,1498747,2186490,842698,4194940,713721,2995136,139928,798540,4205000,21547509,1557250,0,23104759,0,10619084,33723843,POINT (-92.4094499 41.03058450000001)
2015_38_GRUNDY_EXPEND_SA,2015,38,GRUNDY,1931795,565368,792889,933834,4652299,424985,1803896,0,1272268,2084705,14462039,1532600,0,15994639,0,3560473,19555112,POINT (-92.7914177 42.4018651)
2012_65_MILLS_EXPEND_SA,2012,65,MILLS,2672148,1663268,1776873,941949,5779728,472053,1470582,0,103590,230000,15110191,1775000,0,16885191,0,4774905,21660096,POINT (-95.62132670000001 41.0334523)
2011_89_VAN BUREN_EXPEND_SA,2011,89,VAN BUREN,1044418,813295,573070,516042,2835000,293288,559983,1700,0,283600,6920396,593421,0,7513817,0,2046042,9559859,POINT (-91.9499871 40.7532294)
2017_8_BOONE_EXPEND_SA,2017,8,BOONE,3810817,721829,845525,1157101,6514400,694848,2075044,0,743953,1023520,17587037,3084961,0,20671998,0,3355248,24027246,POINT (-93.931671 42.0365493)
2019_22_CLAYTON_EXPEND_SA,2019,22,CLAYTON,3206750,525087,651218,1300917,6836053,742596,1816077,1000,347065,1755000,17181763,1750000,0,18931763,0,6119085,25050848,POINT (-91.34143280000002 42.8447493)
2010_57_LINN_EXPEND_SA,2010,57,LINN,22407104,15635647,33954375,6172240,11681465,3862536,11070222,20108,0,12322000,117125697,14082103,0,131207800,0,13597494,144805294,POINT (-91.5989646 42.0789478)
2016_40_HAMILTON_EXPEND_SA,2016,40,HAMILTON,3001752,1766486,1531438,2876194,4774300,525408,1410019,0,2861198,869425,19616220,3094680,0,22710900,0,17426752,40137652,POINT (-93.7068085 42.3837722)
2017_94_WEBSTER_EXPEND_SA,2017,94,WEBSTER,5407766,3570114,2189957,2109683,8900000,984993,2931137,150000,2606109,6745000,35594759,4355598,0,39950357,0,9999003,49949360,POINT (-94.18178810000002 42.4279662)
2021_51_JEFFERSON_EXPEND_SA,2021,51,JEFFERSON,3743869,809766,822896,734112,4317000,655972,1491684,0,855330,9476262,22906891,1200000,0,24106891,0,3053307,27160198,POINT (-91.9488774 41.0317596)
2019_7_BLACK HAWK_EXPEND_SA,2019,7,BLACK HAWK,21720655,9907090,6466300,3517569,7479418,2209785,6587756,0,7621119,2250261,67759953,10134249,0,77894202,0,22404030,100298232,POINT (-92.3088197 42.4700957)
2018_5_AUDUBON_EXPEND_SA,2018,5,AUDUBON,1514579,671770,145175,648132,3947874,396541,842705,100,157448,1898278,10222602,766200,0,10988802,0,3790257,14779059,POINT (-94.9058222 41.6845893)
2012_18_CHEROKEE_EXPEND_SA,2012,18,CHEROKEE,1824121,348057,1374969,723290,4226059,419225,1526967,0,0,1425000,11867688,1485000,0,13352688,0,4319317,17672005,POINT (-95.6238055 42.7356226)
2009_61_MADISON_EXPEND_SA,2009,61,MADISON,2178835,898299,1520550,638511,3994284,432105,1213294,0,81281,15107,10972266,1059108,0,12031374,0,2538679,14570053,POINT (-94.01556190000001 41.33071420000001)
2022_58_LOUISA_EXPEND_SA,2022,58,LOUISA,3434534,856701,478304,819043,4310451,430690,1538305,0,0,436830,12304858,1727969,0,14032827,0,2277570,16310397,POINT (-91.2596184 41.2185073)
2013_51_JEFFERSON_EXPEND_SA,2013,51,JEFFERSON,2747155,867619,1250000,632679,3025000,525272,964592,0,195165,1322000,11529482,1000000,0,12529482,0,2921223,15450705,POINT (-91.9488774 41.0317596)
2008_28_DELAWARE_EXPEND_SA,2008,28,DELAWARE,1781820,468771,2507051,715338,3689000,496431,1097614,15960,0,2278500,13050485,1468826,0,14519311,0,1485615,16004926,POINT (-91.3673502 42.471211)
2020_89_VAN BUREN_EXPEND_SA,2020,89,VAN BUREN,1436233,576719,251762,387243,4162000,334143,686872,25600,0,505000,8365572,968216,0,9333788,0,4626354,13960142,POINT (-91.9499871 40.7532294)
2014_84_SIOUX_EXPEND_SA,2014,84,SIOUX,4335195,746774,1652748,1137681,6074275,932227,2314145,37000,886813,2538050,20654908,2895920,0,23550828,0,7066365,30617193,POINT (-96.1778827 43.0826174)
2015_23_CLINTON_EXPEND_SA,2015,23,CLINTON,7902450,1696197,4017086,2087964,5901253,1652512,4788961,0,1371098,766678,30184199,1942576,0,32126775,0,5765113,37891888,POINT (-90.5319724 41.8980358)
2007_88_UNION_EXPEND_SA,2007,88,UNION,1207471,345812,1607943,414934,2568945,414340,838228,0,519900,140000,8057573,500898,,8558471,0,1116484,9674955,POINT (-94.2423792 41.0277304)
2007_27_DECATUR_EXPEND_SA,2007,27,DECATUR,811266,960498,1049493,278584,2446689,245910,621006,0,75000,250000,6738446,437141,,7175587,0,1360549,8536136,POINT (-93.7862815 40.7376827)
2016_18_CHEROKEE_EXPEND_SA,2016,18,CHEROKEE,2295188,376443,593255,947041,5198770,484818,1673283,0,0,1378000,12946798,2127000,0,15073798,0,4317944,19391742,POINT (-95.6238055 42.7356226)
2019_17_CERRO GORDO_EXPEND_SA,2019,17,CERRO GORDO,9595749,6168423,2476264,1834408,6940899,1288735,3852865,0,998569,1647012,34802924,7075817,0,41878741,0,13393934,55272675,POINT (-93.2608184 43.081557700000005)
2018_74_PALO ALTO_EXPEND_SA,2018,74,PALO ALTO,2016767,431297,396352,1442964,5493051,493980,1324454,0,1893996,1284674,14777535,2616716,0,17394251,0,8682033,26076284,POINT (-94.6781371 43.0820643)
2018_64_MARSHALL_EXPEND_SA,2018,64,MARSHALL,8119419,803738,1065010,1310766,7131900,1046080,3050613,0,777300,1205302,24510128,3512500,0,28022628,0,9948027,37970655,POINT (-92.9987706 42.0358499)
2010_25_DALLAS_EXPEND_SA,2010,25,DALLAS,7776539,2738108,4708783,2495469,6247019,1850292,1439171,33050,1627615,2166863,31082909,6338371,0,37421280,0,10215002,47636282,POINT (-94.0397374 41.6848862)
2021_9_BREMER_EXPEND_SA,2021,9,BREMER,5266339,1636203,1096089,1626701,5690021,871213,1877127,63900,669200,3085000,21881793,3307964,0,25189757,0,12704591,37894348,POINT (-92.31805480000001 42.7745873)
2012_50_JASPER_EXPEND_SA,2012,50,JASPER,5197948,2114918,5012240,1409255,6105532,1019069,3120456,15500,2003685,1838363,27836966,4751991,0,32588957,0,5969161,38558118,POINT (-93.053765 41.6860394)
2010_84_SIOUX_EXPEND_SA,2010,84,SIOUX,3758530,1748212,2753912,956829,5744150,797852,2031924,40500,881448,5169553,23882910,2028718,0,25911628,0,5353677,31265305,POINT (-96.1778827 43.0826174)
2012_5_AUDUBON_EXPEND_SA,2012,5,AUDUBON,1090329,583969,1054854,476173,3049577,327938,720344,0,79575,445209,7827968,691778,0,8519746,0,2329801,10849547,POINT (-94.9058222 41.6845893)
2016_1_ADAIR_EXPEND_SA,2016,1,ADAIR,1467711,390086,318904,569118,4375223,391353,839186,0,1415161,3368134,13134876,1731043,0,14865919,0,8504854,23370773,POINT (-94.4709413 41.3307464)
2017_47_IDA_EXPEND_SA,2017,47,IDA,821290,336204,229217,408310,3576504,307538,813949,0,0,520000,7013012,1181627,0,8194639,0,1554087,9748726,POINT (-95.5134962 42.3868747)
2020_57_LINN_EXPEND_SA,2020,57,LINN,31723227,17129338,10888202,8425268,15979908,5111418,17427517,0,6791682,43774329,157250889,26143354,0,183394243,0,39305434,222699677,POINT (-91.5989646 42.0789478)
2013_83_SHELBY_EXPEND_SA,2013,83,SHELBY,2063351,574042,2603280,397122,4201650,426378,1112457,31000,132709,590610,12132599,2745610,0,14878209,0,3034444,17912653,POINT (-95.31021130000002 41.6850926)
2016_55_KOSSUTH_EXPEND_SA,2016,55,KOSSUTH,3169610,342145,1173958,1049183,7286000,850360,2201446,83237,0,2175000,18330939,2813273,0,21144212,0,6498227,27642439,POINT (-94.2067199 43.20413)
2022_80_RINGGOLD_EXPEND_SA,2022,80,RINGGOLD,1670475,652269,601820,706810,3581289,309862,1038098,0,182450,815000,9558073,850000,0,10408073,0,3640204,14048277,POINT (-94.2439719 40.7352023)
2017_83_SHELBY_EXPEND_SA,2017,83,SHELBY,2358325,562826,796924,429190,5854661,498569,1227607,92000,200100,1588000,13608202,2946822,0,16555024,0,2724575,19279599,POINT (-95.31021130000002 41.6850926)
2022_90_WAPELLO_EXPEND_SA,2022,90,WAPELLO,5202824,825512,1884736,1092552,5054919,781281,3213012,77673,484662,2420000,21037171,1254000,0,22291171,0,9611252,31902423,POINT (-92.4094499 41.03058450000001)
2017_72_OSCEOLA_EXPEND_SA,2017,72,OSCEOLA,1451280,245191,205225,838348,3484765,273288,933338,240574,462223,145000,8279232,1636429,0,9915661,0,4381639,14297300,POINT (-95.6236852 43.3785704)
2008_21_CLAY_EXPEND_SA,2008,21,CLAY,2155826,414284,1521345,922017,3761960,404060,1578029,0,445700,823500,12026721,1247816,0,13274537,0,4329002,17603539,POINT (-95.1509194 43.0825804)
2011_57_LINN_EXPEND_SA,2011,57,LINN,22851635,14855758,32597256,6962248,11750540,3944523,11159357,20108,70615,16438800,120650840,14729071,0,135379911,0,19153656,154533567,POINT (-91.5989646 42.0789478)
2014_58_LOUISA_EXPEND_SA,2014,58,LOUISA,2594734,717748,666964,3650628,2834459,279096,1012948,0,357190,4322848,16436615,1433664,0,17870279,0,4366068,22236347,POINT (-91.2596184 41.2185073)
2020_50_JASPER_EXPEND_SA,2020,50,JASPER,7657809,2335908,930425,1685079,9298250,1522101,3788655,145030,1390213,3930000,32683470,6241336,0,38924806,0,10507236,49432042,POINT (-93.053765 41.6860394)
2015_28_DELAWARE_EXPEND_SA,2015,28,DELAWARE,2531695,643899,1788107,966995,5620319,829298,1528363,48900,404330,4979499,19341405,2141936,0,21483341,0,3613103,25096444,POINT (-91.3673502 42.471211)
2006_58_LOUISA_EXPEND_SA,2006,58,LOUISA,1599362,577104,1254839,476728,2653706,373422,821544,0,54940,974567,8786212,1137061,,9923273,0,2396266,12319539,POINT (-91.2596184 41.2185073)
2011_22_CLAYTON_EXPEND_SA,2011,22,CLAYTON,2432752,588889,2357783,1185695,6000657,602040,1208883,1300,289209,2213000,16880208,1400000,0,18280208,0,4749574,23029782,POINT (-91.34143280000002 42.8447493)
2018_42_HARDIN_EXPEND_SA,2018,42,HARDIN,4718940,451406,675785,1057233,6513990,676777,2017311,322482,2492886,756300,19683110,2136363,0,21819473,0,6765506,28584979,POINT (-93.2404025 42.3838803)
2018_89_VAN BUREN_EXPEND_SA,2018,89,VAN BUREN,1221486,491395,249780,370364,3515000,282895,707410,5600,0,1789500,8633430,727267,0,9360697,0,2931500,12292197,POINT (-91.9499871 40.7532294)
2016_33_FAYETTE_EXPEND_SA,2016,33,FAYETTE,3787053,541234,1542062,1590164,5610225,825843,1623450,37400,360000,1199850,17117281,1893954,0,19011235,0,3106821,22118056,POINT (-91.8443207 42.8625919)
2015_75_PLYMOUTH_EXPEND_SA,2015,75,PLYMOUTH,3512506,365956,1280021,980989,9512000,806496,4676691,0,1658326,1770000,24562985,3885543,0,28448528,0,4548081,32996609,POINT (-96.2140431 42.7378346)
2016_23_CLINTON_EXPEND_SA,2016,23,CLINTON,7673727,1649453,2907233,1895710,5827290,1172303,3908204,820000,1368335,1919276,29141531,1981506,0,31123037,0,6848736,37971773,POINT (-90.5319724 41.8980358)
2017_40_HAMILTON_EXPEND_SA,2017,40,HAMILTON,3188960,1709390,1453244,2457024,5120148,534287,1505665,0,2671937,2408926,21049581,3010702,0,24060283,0,17134527,41194810,POINT (-93.7068085 42.3837722)
2012_33_FAYETTE_EXPEND_SA,2012,33,FAYETTE,3036472,551368,2930859,1527235,5170900,689957,1230430,307000,352148,744820,16541189,1702282,0,18243471,0,1742824,19986295,POINT (-91.8443207 42.8625919)
2014_90_WAPELLO_EXPEND_SA,2014,90,WAPELLO,3863559,1598865,2091565,858410,3985750,744584,2834936,138026,748411,1697000,18561106,1500000,0,20061106,0,5902555,25963661,POINT (-92.4094499 41.03058450000001)
2009_8_BOONE_EXPEND_SA,2009,8,BOONE,3085607,735410,2619593,1088257,5208566,658645,1752397,1800000,518100,1118600,18585175,1919217,0,20504392,0,2962703,23467095,POINT (-93.931671 42.0365493)
2020_14_CARROLL_EXPEND_SA,2020,14,CARROLL,4538438,1129003,653561,1172931,6622350,699263,2203289,55000,642462,928500,18644797,3572617,0,22217414,0,4893922,27111336,POINT (-94.8605593 42.0362382)
2005_10_BUCHANAN_EXPEND_SA,2005,10,BUCHANAN,2429318,244165,2779928,612057,4437000,378310,1421547,30766,100017,468750,12901858,1521477,,14423335,0,1096886,15520221,POINT (-91.8378392 42.4707777)
2021_4_APPANOOSE_EXPEND_SA,2021,4,APPANOOSE,3002586,525850,557304,877113,4408943,598511,1135175,0,100775,750000,11956257,830938,0,12787195,0,6019678,18806873,POINT (-92.8686104 40.7431635)
2019_40_HAMILTON_EXPEND_SA,2019,40,HAMILTON,3438693,1666437,1292016,2444106,5534050,578264,1672579,0,2403403,2134053,21163601,3180581,0,24344182,0,4440996,28785178,POINT (-93.7068085 42.3837722)
2016_8_BOONE_EXPEND_SA,2016,8,BOONE,3601509,708732,877675,1147567,5866200,691580,1931331,0,742065,1341860,16908519,3040042,0,19948561,0,3549216,23497777,POINT (-93.931671 42.0365493)
2006_90_WAPELLO_EXPEND_SA,2006,90,WAPELLO,3277869,1544446,4024366,674768,3351300,762736,2106785,99290,204158,989000,17034718,885059,,17919777,0,6459066,24378843,POINT (-92.4094499 41.03058450000001)
2021_89_VAN BUREN_EXPEND_SA,2021,89,VAN BUREN,1495697,609165,302275,462934,5230000,329806,752964,25600,0,514200,9722641,980000,0,10702641,0,2775369,13478010,POINT (-91.9499871 40.7532294)
2020_56_LEE_EXPEND_SA,2020,56,LEE,7100596,4617890,1287337,1716519,6538624,1409673,2365330,27809,871645,1780569,27715992,2313484,0,30029476,0,9046685,39076161,POINT (-91.479264 40.6419764)
2015_17_CERRO GORDO_EXPEND_SA,2015,17,CERRO GORDO,8604385,5287162,2649580,1372986,5724050,1507339,3082226,0,1031952,1150000,30409680,5843316,0,36252996,0,10153352,46406348,POINT (-93.2608184 43.081557700000005)
2008_92_WASHINGTON_EXPEND_SA,2008,92,WASHINGTON,3568076,2442619,1974131,631242,4043460,635343,1548788,57600,904879,2380500,18186638,1810457,0,19997095,0,3152981,23150076,POINT (-91.7178676 41.335591)
2005_54_KEOKUK_EXPEND_SA,2005,54,KEOKUK,890730,671448,1009533,447560,4156600,338248,1080453,1000,8000,405900,9009472,1430000,,10439472,0,2133040,12572512,POINT (-92.1786426 41.336465)
2016_50_JASPER_EXPEND_SA,2016,50,JASPER,6126406,2219069,206860,1460697,8634820,1574250,3168303,28000,1615433,1220700,26254538,8888789,0,35143327,0,4355502,39498829,POINT (-93.053765 41.6860394)
2022_37_GREENE_EXPEND_SA,2022,37,GREENE,3049062,582832,176100,1233123,6075062,412054,2213073,110000,339885,775000,14966191,1865342,0,16831533,0,3419756,20251289,POINT (-94.3968356 42.0362394)
2008_60_LYON_EXPEND_SA,2008,60,LYON,2287248,776612,998191,733198,3394970,399579,907597,17335,280575,230000,10025305,1205385,0,11230690,0,3639846,14870536,POINT (-96.2102924 43.380497)
2006_71_O'BRIEN_EXPEND_SA,2006,71,O'BRIEN,2476309,433904,1616104,730957,2898350,586609,778586,11000,305669,901000,10738488,1161026,,11899514,0,2560620,14460134,POINT (-95.6248784 43.0837527)
2010_99_WRIGHT_EXPEND_SA,2010,99,WRIGHT,1757507,3369317,1933529,982734,3737750,491144,1213314,39720,167336,766000,14458351,1385276,0,15843627,0,2939657,18783284,POINT (-93.7351465 42.7331189)
2006_43_HARRISON_EXPEND_SA,2006,43,HARRISON,1734136,1380306,1578317,736620,4548000,443012,1030381,0,558926,404850,12414548,1161000,,13575548,0,6642433,20217981,POINT (-95.8169209 41.6828528)
2013_78_POTTAWATTAMIE_EXPEND_SA,2013,78,POTTAWATTAMIE,21663898,3546519,11506284,14394271,12627855,2348981,6527018,0,3838946,6770000,83223772,6166387,0,89390159,0,13265161,102655320,POINT (-95.5423935 41.3366123)
2011_17_CERRO GORDO_EXPEND_SA,2011,17,CERRO GORDO,7570996,5478646,4945010,1339397,5551114,1025575,2603919,40000,976358,6450000,35981015,5363503,0,41344518,0,8740102,50084620,POINT (-93.2608184 43.081557700000005)
2022_73_PAGE_EXPEND_SA,2022,73,PAGE,3073439,634122,347461,531447,5016600,652982,1783676,8000,429816,100000,12577543,1589434,0,14166977,0,6293827,20460804,POINT (-95.1501747 40.7391444)
2012_91_WARREN_EXPEND_SA,2012,91,WARREN,4239270,3300232,3550656,1182629,5802326,823776,2579095,17900,25905,824694,22346483,2482000,0,24828483,0,5982490,30810973,POINT (-93.5613594 41.3343735)
2009_25_DALLAS_EXPEND_SA,2009,25,DALLAS,7184451,2998888,5081109,3328122,5851213,1732418,1411835,33000,1385629,2956369,31963034,3392339,0,35355373,0,8725317,44080690,POINT (-94.0397374 41.6848862)
2016_30_DICKINSON_EXPEND_SA,2016,30,DICKINSON,2629903,535967,826871,2405960,5278350,804900,2075205,257500,1707873,2100547,18623076,3067227,0,21690303,0,8404050,30094353,POINT (-95.1508301 43.3779848)
2010_5_AUDUBON_EXPEND_SA,2010,5,AUDUBON,1077868,634281,999370,1102670,2989465,321521,729513,100,136313,33999,8025100,634428,0,8659528,0,2043980,10703508,POINT (-94.9058222 41.6845893)
2014_99_WRIGHT_EXPEND_SA,2014,99,WRIGHT,2084646,4080602,1412746,1005794,4904500,537476,1359855,24600,305295,1349000,17064514,1801060,0,18865574,0,3823630,22689204,POINT (-93.7351465 42.7331189)
2013_66_MITCHELL_EXPEND_SA,2013,66,MITCHELL,1460421,1699323,615000,1100814,3595000,328200,1215051,0,1306606,5090000,16410415,1492118,0,17902533,0,3680944,21583477,POINT (-92.7890315 43.3564124)
2019_12_BUTLER_EXPEND_SA,2019,12,BUTLER,2591619,1398471,763786,1408128,6060000,626952,2035887,20000,588115,3054851,18547809,3161615,0,21709424,0,5799590,27509014,POINT (-92.7901934 42.7315661)
2006_11_BUENA VISTA_EXPEND_SA,2006,11,BUENA VISTA,2104416,1030299,1569827,714085,4193200,506385,1104779,483750,694111,1813690,14214542,1627069,,15841611,0,3426471,19268082,POINT (-95.15114900000002 42.7354936)
2008_32_EMMET_EXPEND_SA,2008,32,EMMET,1339316,629840,1584086,389864,2451610,368841,933763,0,15300,739671,8452291,593785,0,9046076,0,1203130,10249206,POINT (-94.6784803 43.37802250000001)
2020_83_SHELBY_EXPEND_SA,2020,83,SHELBY,2558141,677264,301406,492947,6346053,437218,1319472,0,200000,508522,12841023,3334210,0,16175233,0,3559898,19735131,POINT (-95.31021130000002 41.6850926)
2009_76_POCAHONTAS_EXPEND_SA,2009,76,POCAHONTAS,1422657,1567991,1142560,847318,3733690,400234,1222998,7385,0,723600,11068433,850000,0,11918433,0,2810004,14728437,POINT (-94.67874660000001 42.73413510000001)
2007_59_LUCAS_EXPEND_SA,2007,59,LUCAS,873353,552501,1107688,225256,2720220,290657,859842,121250,111364,2410000,9272131,504207,,9776338,0,648649,10424987,POINT (-93.3277207 41.0293738)
2020_9_BREMER_EXPEND_SA,2020,9,BREMER,4691097,1565194,1103231,1658475,5721000,812593,1913320,48300,325095,1770000,19608305,3423098,0,23031403,0,12773488,35804891,POINT (-92.31805480000001 42.7745873)
2022_1_ADAIR_EXPEND_SA,2022,1,ADAIR,1888446,321563,257000,588351,5480020,505152,1053376,0,3445273,8967000,22506181,1215663,0,23721844,0,6896128,30617972,POINT (-94.4709413 41.3307464)
2013_93_WAYNE_EXPEND_SA,2013,93,WAYNE,1144401,950276,745352,217260,3079729,243785,799407,33200,399038,150000,7762448,627300,0,8389748,0,1446482,9836230,POINT (-93.3273639 40.73947020000001)
2018_43_HARRISON_EXPEND_SA,2018,43,HARRISON,2854930,1828219,328095,1218598,6170000,600444,1656912,0,120065,1531000,16308263,2197000,0,18505263,0,9014569,27519832,POINT (-95.8169209 41.6828528)
2016_72_OSCEOLA_EXPEND_SA,2016,72,OSCEOLA,1460080,201697,288025,503426,3079213,330503,853961,105750,480438,155000,7458093,1568784,0,9026877,0,3395407,12422284,POINT (-95.6236852 43.3785704)
2015_39_GUTHRIE_EXPEND_SA,2015,39,GUTHRIE,1360400,1375235,294814,1152486,4575741,411100,1024164,15000,0,810000,11018940,1656831,0,12675771,0,5093660,17769431,POINT (-94.501055 41.6837548)
2015_93_WAYNE_EXPEND_SA,2015,93,WAYNE,1371553,1292632,300478,406083,3214150,252426,864513,32200,404426,210000,8348461,495604,0,8844065,0,3268926,12112991,POINT (-93.3273639 40.73947020000001)
2009_93_WAYNE_EXPEND_SA,2009,93,WAYNE,4164247,745672,635330,502882,2687556,307494,762853,44750,0,88250,9939034,482908,0,10421942,0,1519972,11941914,POINT (-93.3273639 40.73947020000001)
2018_75_PLYMOUTH_EXPEND_SA,2018,75,PLYMOUTH,4094542,396502,458417,1079791,7969000,901410,2397822,0,1236046,3940000,22473530,4305100,0,26778630,0,4838832,31617462,POINT (-96.2140431 42.7378346)
2006_26_DAVIS_EXPEND_SA,2006,26,DAVIS,928316,278945,754000,254959,2583560,368288,777766,20000,0,400000,6365834,584855,,6950689,0,1086190,8036879,POINT (-92.4097173 40.7476891)
2007_28_DELAWARE_EXPEND_SA,2007,28,DELAWARE,1706964,490105,2243219,730050,3545000,461665,1065016,25960,0,2202500,12470479,1364128,,13834607,0,1381611,15216218,POINT (-91.3673502 42.471211)
2021_76_POCAHONTAS_EXPEND_SA,2021,76,POCAHONTAS,2457860,1603883,203700,1079761,5359291,429440,1819423,60885,0,1416701,14430944,1861945,0,16292889,0,9895078,26187967,POINT (-94.67874660000001 42.73413510000001)
2008_43_HARRISON_EXPEND_SA,2008,43,HARRISON,1968913,1766483,1695125,823098,4683000,490708,1186552,0,485364,827350,13926593,1216072,0,15142665,0,5577437,20720102,POINT (-95.8169209 41.6828528)
2018_6_BENTON_EXPEND_SA,2018,6,BENTON,4758134,1121162,1138102,2398827,7987790,798884,2154201,155000,182253,2151000,22845353,4341288,0,27186641,0,5795567,32982208,POINT (-92.0656912 42.0801864)
2014_43_HARRISON_EXPEND_SA,2014,43,HARRISON,2548462,1661408,1009100,1013166,6043000,658650,1285872,0,231271,1113000,15563929,1861000,0,17424929,0,7005450,24430379,POINT (-95.8169209 41.6828528)
2005_78_POTTAWATTAMIE_EXPEND_SA,2005,78,POTTAWATTAMIE,14210297,2957568,8177319,2053021,10185870,1609553,6344639,0,1646141,290000,47474408,4253984,,51728392,0,5850446,57578838,POINT (-95.5423935 41.3366123)
2010_60_LYON_EXPEND_SA,2010,60,LYON,2553557,881347,1064704,772472,4091210,452179,903713,28125,255710,221000,11224017,1200867,0,12424884,0,4144959,16569843,POINT (-96.2102924 43.380497)
2012_61_MADISON_EXPEND_SA,2012,61,MADISON,2448078,872927,1449550,653580,4397322,458218,923589,0,110704,1322804,12636772,1445766,0,14082538,0,2376665,16459203,POINT (-94.01556190000001 41.33071420000001)
2016_94_WEBSTER_EXPEND_SA,2016,94,WEBSTER,5408581,3771539,2983036,1852280,10770000,998296,2977973,150000,2827365,1580000,33319070,6719041,0,40038111,0,9450024,49488135,POINT (-94.18178810000002 42.4279662)
2022_57_LINN_EXPEND_SA,2022,57,LINN,34099575,17917386,10118465,8782507,16243020,5566027,18554515,0,5501880,13915000,130698375,25550281,0,156248656,0,39520578,195769234,POINT (-91.5989646 42.0789478)
2006_95_WINNEBAGO_EXPEND_SA,2006,95,WINNEBAGO,1150222,686918,1298380,678267,2566000,454365,877319,4000,0,145500,7860971,1409793,,9270764,0,2583794,11854558,POINT (-93.7341955 43.37756780000001)
2019_76_POCAHONTAS_EXPEND_SA,2019,76,POCAHONTAS,2345999,1700288,337015,1105737,4581528,436774,1594137,11385,0,1214502,13327365,1541996,0,14869361,0,8591735,23461096,POINT (-94.67874660000001 42.73413510000001)
2010_43_HARRISON_EXPEND_SA,2010,43,HARRISON,1874984,1655218,2093300,824532,4897512,456356,1815888,0,480851,2450600,16549241,1294530,0,17843771,0,6720274,24564045,POINT (-95.8169209 41.6828528)
2011_76_POCAHONTAS_EXPEND_SA,2011,76,POCAHONTAS,1689236,1599452,1099227,963114,4128347,350196,1505607,10385,0,991000,12336564,1100000,0,13436564,0,-67914,13368650,POINT (-94.67874660000001 42.73413510000001)
2014_11_BUENA VISTA_EXPEND_SA,2014,11,BUENA VISTA,3518100,1302894,932697,701602,4778175,771234,1690114,7200,886264,2023563,16611843,2338022,0,18949865,0,6611171,25561036,POINT (-95.15114900000002 42.7354936)
2011_93_WAYNE_EXPEND_SA,2011,93,WAYNE,1109374,1042868,751535,392931,2619500,264389,819666,32700,0,65000,7097963,475964,0,7573927,0,4766530,12340457,POINT (-93.3273639 40.73947020000001)
2015_86_TAMA_EXPEND_SA,2015,86,TAMA,3430818,1599820,427630,868112,7158780,511231,1408612,26750,153735,4458052,20043540,2280927,0,22324467,0,6613595,28938062,POINT (-92.5325425 42.07981170000001)
2009_81_SAC_EXPEND_SA,2009,81,SAC,1845810,570042,1435239,790798,3726700,340786,1069763,0,55000,886000,10720138,1007035,0,11727173,0,1667147,13394320,POINT (-95.1053946 42.3862604)
2019_39_GUTHRIE_EXPEND_SA,2019,39,GUTHRIE,1943451,1619358,284498,1481837,5733089,546756,1724462,30000,780040,1865000,16008491,1814897,0,17823388,0,6342242,24165630,POINT (-94.501055 41.6837548)
2011_49_JACKSON_EXPEND_SA,2011,49,JACKSON,1649540,420238,2376420,1283514,4143762,518991,1445597,121900,0,637656,12597618,1910701,0,14508319,0,3455239,17963558,POINT (-90.5742294 42.1717426)
2019_29_DES MOINES_EXPEND_SA,2019,29,DES MOINES,7731425,1920869,1874420,2017020,6070287,1100471,3350998,0,4410917,9846941,38323348,2294433,0,40617781,0,6331223,46949004,POINT (-91.1814707 40.9231829)
2010_32_EMMET_EXPEND_SA,2010,32,EMMET,1518389,684439,1612099,438579,2565699,397789,1148209,0,15300,127798,8508301,652192,0,9160493,0,1077520,10238013,POINT (-94.6784803 43.37802250000001)
2011_44_HENRY_EXPEND_SA,2011,44,HENRY,3114692,758590,2901171,936907,3697000,565232,1139854,43400,146318,1506400,14809564,1043037,0,15852601,0,3197521,19050122,POINT (-91.5445241 40.9879383)
2021_1_ADAIR_EXPEND_SA,2021,1,ADAIR,1897571,314188,252000,555800,7111866,481351,1008181,0,3075934,11321590,26018481,1181192,0,27199673,0,7069050,34268723,POINT (-94.4709413 41.3307464)
2022_18_CHEROKEE_EXPEND_SA,2022,18,CHEROKEE,2947365,432153,537138,1155911,8216634,685844,1729625,150000,0,2610000,18464670,2228787,0,20693457,0,4147071,24840528,POINT (-95.6238055 42.7356226)
2009_94_WEBSTER_EXPEND_SA,2009,94,WEBSTER,4896486,2428431,4986844,1299574,6500000,832084,2661147,355000,575229,2375000,26909795,2045000,0,28954795,0,7880284,36835079,POINT (-94.18178810000002 42.4279662)
2017_27_DECATUR_EXPEND_SA,2017,27,DECATUR,1171733,719734,830585,478735,3343224,316574,845563,0,319928,210000,8236076,485000,0,8721076,0,1617782,10338858,POINT (-93.7862815 40.7376827)
2019_61_MADISON_EXPEND_SA,2019,61,MADISON,3163978,879082,353468,891415,6146840,602974,1554496,0,137130,1444224,15173607,1902354,0,17075961,0,3698667,20774628,POINT (-94.01556190000001 41.33071420000001)
2015_27_DECATUR_EXPEND_SA,2015,27,DECATUR,1122450,1281794,850612,378692,3068410,309800,946550,0,251500,215000,8424808,465000,0,8889808,0,1544991,10434799,POINT (-93.7862815 40.7376827)
2017_20_CLARKE_EXPEND_SA,2017,20,CLARKE,1971836,988562,1065772,300242,3646100,518748,1308711,0,237457,45000,10082428,676992,0,10759420,0,2166312,12925732,POINT (-93.78515790000002 41.0290323)
2010_96_WINNESHIEK_EXPEND_SA,2010,96,WINNESHIEK,2129638,1686611,2651319,1257331,5388580,357243,1524289,0,498636,1253610,16747257,1958320,0,18705577,0,4084902,22790479,POINT (-91.8437074 43.2906746)
2021_61_MADISON_EXPEND_SA,2021,61,MADISON,3710735,961589,489856,1022131,6372847,674240,1693364,0,138620,2576070,17639452,2427168,0,20066620,0,3996811,24063431,POINT (-94.01556190000001 41.33071420000001)
2021_29_DES MOINES_EXPEND_SA,2021,29,DES MOINES,8258058,1541604,1817452,1405246,6623300,1138097,3248801,0,4093784,7694784,35821126,2540957,0,38362083,0,7492659,45854742,POINT (-91.1814707 40.9231829)
2011_86_TAMA_EXPEND_SA,2011,86,TAMA,3175768,1439374,1916356,903099,6870918,483722,1162774,7750,0,1805774,17765535,2022564,0,19788099,0,2562281,22350380,POINT (-92.5325425 42.07981170000001)
2015_50_JASPER_EXPEND_SA,2015,50,JASPER,5595912,1914295,1669429,1498601,7112780,1215682,3142599,30500,1959180,3044568,27183546,5394417,0,32577963,0,7450752,40028715,POINT (-93.053765 41.6860394)
2014_80_RINGGOLD_EXPEND_SA,2014,80,RINGGOLD,1328046,911398,66113,246562,3962326,257775,1576873,11000,193315,420000,8973408,711738,0,9685146,0,2466321,12151467,POINT (-94.2439719 40.7352023)
2016_67_MONONA_EXPEND_SA,2016,67,MONONA,1906512,533984,300993,807633,5393165,503175,1630182,0,45980,2134600,13256224,1551110,0,14807334,0,4541163,19348497,POINT (-95.9599235 42.0516663)
2010_53_JONES_EXPEND_SA,2010,53,JONES,2126680,893920,2818603,1241426,5807773,558123,1620826,108311,32261,1225000,16432923,1808000,0,18240923,0,1867829,20108752,POINT (-91.1314352 42.1212397)
2022_62_MAHASKA_EXPEND_SA,2022,62,MAHASKA,4129859,782706,1086200,1454386,7636567,761021,1697872,0,1115920,5020000,23684531,2353648,0,26038179,0,11300917,37339096,POINT (-92.6409094 41.3352035)
2007_15_CASS_EXPEND_SA,2007,15,CASS,1987679,493179,2012054,597532,3737600,383286,1061001,132000,0,2112823,12517154,1568822,,14085976,0,917403,15003379,POINT (-94.9278266 41.3314876)
2012_14_CARROLL_EXPEND_SA,2012,14,CARROLL,3033096,1238971,3429946,1104655,4920700,474474,1608759,100000,0,1288600,17199201,1880000,0,19079201,0,6934513,26013714,POINT (-94.8605593 42.0362382)
2005_97_WOODBURY_EXPEND_SA,2005,97,WOODBURY,9586044,3700200,9215361,1492695,6148205,1878041,5627163,458525,384318,2266627,40757179,4342334,,45099513,0,7552124,52651637,POINT (-96.0447673 42.3897169)
2019_34_FLOYD_EXPEND_SA,2019,34,FLOYD,3272770,1388374,940401,794926,5672758,690957,1376314,0,654000,2025000,16815500,1313315,0,18128815,0,6146771,24275586,POINT (-92.78900330000002 43.0599208)
2011_29_DES MOINES_EXPEND_SA,2011,29,DES MOINES,6326162,2486415,4200795,3834802,4418789,1019157,3392051,0,682370,2174000,28534541,1731971,0,30266512,0,2293344,32559856,POINT (-91.1814707 40.9231829)
2013_46_HUMBOLDT_EXPEND_SA,2013,46,HUMBOLDT,1727618,387203,1337909,695111,3236762,380167,1024917,0,0,118000,8907687,1494070,0,10401757,0,2252522,12654279,POINT (-94.2071868 42.7764686)
2018_38_GRUNDY_EXPEND_SA,2018,38,GRUNDY,2235149,563983,813924,946986,5364307,467585,1849490,0,1826378,2569626,16637428,1849100,0,18486528,0,3745154,22231682,POINT (-92.7914177 42.4018651)
2008_97_WOODBURY_EXPEND_SA,2008,97,WOODBURY,11638407,4964459,10484484,1913139,6905369,2094125,6116580,930017,623808,2212000,47882388,5591387,0,53473775,0,8506297,61980072,POINT (-96.0447673 42.3897169)
2016_26_DAVIS_EXPEND_SA,2016,26,DAVIS,1236515,391082,481794,387399,4004442,390688,959152,30493,73087,460000,8414652,804843,0,9219495,0,1531559,10751054,POINT (-92.4097173 40.7476891)
2011_54_KEOKUK_EXPEND_SA,2011,54,KEOKUK,931995,658405,1050196,352661,3590500,342247,1640290,0,0,846000,9412294,1004000,0,10416294,0,5610587,16026881,POINT (-92.1786426 41.336465)
2022_94_WEBSTER_EXPEND_SA,2022,94,WEBSTER,6821761,4823991,1730596,2352435,12233301,1172535,3416978,0,3063000,8730375,44344972,6575147,0,50920119,0,17805659,68725778,POINT (-94.18178810000002 42.4279662)
2017_76_POCAHONTAS_EXPEND_SA,2017,76,POCAHONTAS,2191094,1546161,527751,1149367,4290813,343110,1550818,11385,0,2661503,14272002,1225000,0,15497002,0,4727868,20224870,POINT (-94.67874660000001 42.73413510000001)
2015_8_BOONE_EXPEND_SA,2015,8,BOONE,3520389,758270,1417500,1356344,5831900,674235,1822945,0,742002,1001200,17124785,2795228,0,19920013,0,3451365,23371378,POINT (-93.931671 42.0365493)
2021_5_AUDUBON_EXPEND_SA,2021,5,AUDUBON,1821003,478990,156655,619046,4743381,540567,1034533,100,445038,1024832,10864145,1101200,0,11965345,0,2525368,14490713,POINT (-94.9058222 41.6845893)
2016_11_BUENA VISTA_EXPEND_SA,2016,11,BUENA VISTA,4002384,1379873,1067907,859214,4960185,831972,1925350,7500,962623,2294090,18291098,2463318,0,20754416,0,4937831,25692247,POINT (-95.15114900000002 42.7354936)
2014_95_WINNEBAGO_EXPEND_SA,2014,95,WINNEBAGO,1612387,1025489,841685,911976,3244227,485491,1417844,101377,1529500,2997710,14167686,1566462,0,15734148,0,2966434,18700582,POINT (-93.7341955 43.37756780000001)
2012_9_BREMER_EXPEND_SA,2012,9,BREMER,3382778,438426,2390458,1245635,4292700,692191,1539841,83000,461651,1286000,15812680,2763750,0,18576430,0,9633946,28210376,POINT (-92.31805480000001 42.7745873)
2010_21_CLAY_EXPEND_SA,2010,21,CLAY,2273711,509552,1813704,990540,4428912,401256,1705071,0,352290,1519000,13994036,2400320,0,16394356,0,4461767,20856123,POINT (-95.1509194 43.0825804)
2016_62_MAHASKA_EXPEND_SA,2016,62,MAHASKA,3206723,783510,1037174,932105,5660000,662612,1341645,890000,8490,0,14522259,2174530,0,16696789,0,7513828,24210617,POINT (-92.6409094 41.3352035)
2019_93_WAYNE_EXPEND_SA,2019,93,WAYNE,1823652,1234575,518830,368835,3339930,287022,957851,20000,265487,1595000,10411182,659807,0,11070989,0,4040624,15111613,POINT (-93.3273639 40.73947020000001)
2017_62_MAHASKA_EXPEND_SA,2017,62,MAHASKA,3735563,810591,882013,917852,6317000,680644,1308598,531070,8490,1260000,16451821,2207679,0,18659500,0,8191185,26850685,POINT (-92.6409094 41.3352035)
2018_11_BUENA VISTA_EXPEND_SA,2018,11,BUENA VISTA,4342481,1485816,855765,1037748,7440000,850831,1960330,111100,788770,1721300,20594141,2553224,0,23147365,0,7812360,30959725,POINT (-95.15114900000002 42.7354936)
2019_66_MITCHELL_EXPEND_SA,2019,66,MITCHELL,1987221,1277898,608919,1476813,4315000,411880,1554066,0,4275746,500000,16407543,1396180,0,17803723,0,4380353,22184076,POINT (-92.7890315 43.3564124)
2012_46_HUMBOLDT_EXPEND_SA,2012,46,HUMBOLDT,1551074,405857,1472895,621637,2995139,390247,1003389,0,0,157000,8597238,1363697,0,9960935,0,4559436,14520371,POINT (-94.2071868 42.7764686)
2020_46_HUMBOLDT_EXPEND_SA,2020,46,HUMBOLDT,2349724,419264,503521,880614,3958720,482284,1360701,5000,147397,450000,10557225,1911783,0,12469008,0,3894199,16363207,POINT (-94.2071868 42.7764686)
2020_55_KOSSUTH_EXPEND_SA,2020,55,KOSSUTH,3537814,335984,769932,1162384,8195600,1070061,2716993,56325,0,2740000,20585093,3165713,0,23750806,0,7211084,30961890,POINT (-94.2067199 43.20413)
2019_71_O'BRIEN_EXPEND_SA,2019,71,O'BRIEN,3590479,488548,197870,1122289,4900000,627585,1444031,13500,0,2369000,14753302,3148050,0,17901352,0,6202637,24103989,POINT (-95.6248784 43.0837527)
2018_96_WINNESHIEK_EXPEND_SA,2018,96,WINNESHIEK,4580608,1390759,934213,2542671,7651750,642379,2508295,6500,0,3770000,24027175,2679489,0,26706664,0,6727300,33433964,POINT (-91.8437074 43.2906746)
2017_79_POWESHIEK_EXPEND_SA,2017,79,POWESHIEK,3059622,353748,421897,571434,5918260,698446,1376514,120000,839840,2416500,15776261,2324214,0,18100475,0,6201979,24302454,POINT (-92.53146840000001 41.6864422)
2017_44_HENRY_EXPEND_SA,2017,44,HENRY,3526902,991511,731864,1071344,5277508,669316,1480511,59100,233500,1269500,15311056,1423913,0,16734969,0,3914014,20648983,POINT (-91.5445241 40.9879383)
2016_43_HARRISON_EXPEND_SA,2016,43,HARRISON,2805129,1770536,476223,1135524,6025000,641065,1414005,0,0,1018600,15286082,2011500,0,17297582,0,8667290,25964872,POINT (-95.8169209 41.6828528)
2011_61_MADISON_EXPEND_SA,2011,61,MADISON,2270229,885604,1509050,617367,4432864,451240,1058718,0,85673,689030,11999775,1363200,0,13362975,0,3206841,16569816,POINT (-94.01556190000001 41.33071420000001)
2021_85_STORY_EXPEND_SA,2021,85,STORY,15348114,2787103,3228316,4602609,7658650,1538115,7451052,20000,1507111,5401722,49542792,3526700,0,53069492,0,19014829,72084321,POINT (-93.4650448 42.0362415)
2020_68_MONROE_EXPEND_SA,2020,68,MONROE,2332389,845048,306975,722615,3049100,505492,1399610,0,885370,1709500,11756099,1537288,0,13293387,0,4221697,17515084,POINT (-92.8689877 41.0297826)
2017_5_AUDUBON_EXPEND_SA,2017,5,AUDUBON,1416482,673455,180657,608432,4022127,365243,811786,100,97000,3808287,11983569,910171,0,12893740,0,3672754,16566494,POINT (-94.9058222 41.6845893)
2015_71_O'BRIEN_EXPEND_SA,2015,71,O'BRIEN,3209762,442602,898844,877217,4475000,588039,1324930,9500,863670,900000,13589564,2454683,0,16044247,0,3299253,19343500,POINT (-95.6248784 43.0837527)
2015_61_MADISON_EXPEND_SA,2015,61,MADISON,2645599,808327,746935,761195,4517693,485292,1009106,0,95465,1382647,12452259,1558463,0,14010722,0,3341704,17352426,POINT (-94.01556190000001 41.33071420000001)
2009_62_MAHASKA_EXPEND_SA,2009,62,MAHASKA,2669568,858937,2687919,741318,4764000,619435,1419732,1048300,8490,4335400,19153099,1547103,0,20700202,0,8212787,28912989,POINT (-92.6409094 41.3352035)
2014_94_WEBSTER_EXPEND_SA,2014,94,WEBSTER,5214689,2887383,3186859,1614132,6960000,960426,2993576,250000,1072476,7271806,32411347,3728430,0,36139777,0,9904311,46044088,POINT (-94.18178810000002 42.4279662)
2006_75_PLYMOUTH_EXPEND_SA,2006,75,PLYMOUTH,2401873,285000,1809308,724955,5466000,667720,2364502,0,752027,2082157,16553542,1847000,,18400542,0,4305825,22706367,POINT (-96.2140431 42.7378346)
2014_21_CLAY_EXPEND_SA,2014,21,CLAY,3012267,784903,1098563,1338055,4994812,510902,1647561,0,500498,460000,14347561,1697782,0,16045343,0,5790223,21835566,POINT (-95.1509194 43.0825804)
2012_29_DES MOINES_EXPEND_SA,2012,29,DES MOINES,6359144,1803827,4555691,1617056,5270544,1070886,3548666,0,681710,1183000,26090524,1798977,0,27889501,0,2062329,29951830,POINT (-91.1814707 40.9231829)
2005_14_CARROLL_EXPEND_SA,2005,14,CARROLL,2155613,946719,2822599,794266,3261600,350092,1121046,250000,36700,780300,12518935,950865,,13469800,0,2020681,15490481,POINT (-94.8605593 42.0362382)
2006_31_DUBUQUE_EXPEND_SA,2006,31,DUBUQUE,9840930,12260988,8562878,2499055,5750107,1324993,2620744,107650,497400,3773073,47237818,5870376,,53108194,0,2920219,56028413,POINT (-90.8824564 42.468832)
2015_13_CALHOUN_EXPEND_SA,2015,13,CALHOUN,2290551,2122153,517210,902026,4933428,628102,1192116,5225,0,834105,13424916,1376970,0,14801886,0,8477283,23279169,POINT (-94.6404136 42.385184800000005)
2010_75_PLYMOUTH_EXPEND_SA,2010,75,PLYMOUTH,2861120,290360,1909850,946642,6394000,711882,2517950,0,1265731,1354725,18252260,3018799,0,21271059,0,2045450,23316509,POINT (-96.2140431 42.7378346)
2019_44_HENRY_EXPEND_SA,2019,44,HENRY,3987494,1510378,351888,1117641,5004863,752197,1604172,70800,864962,9854200,25118595,1540944,0,26659539,0,4281115,30940654,POINT (-91.5445241 40.9879383)
2021_16_CEDAR_EXPEND_SA,2021,16,CEDAR,4537299,1745049,511363,1974083,6729000,572957,2033735,8000,0,2800000,20911486,2920448,0,23831934,0,4804740,28636674,POINT (-91.1324125 41.7723207)
2017_59_LUCAS_EXPEND_SA,2017,59,LUCAS,1197244,578946,411383,442433,3923233,327814,1018372,0,339422,1316600,9555447,606130,0,10161577,0,772932,10934509,POINT (-93.3277207 41.0293738)
2022_33_FAYETTE_EXPEND_SA,2022,33,FAYETTE,4737834,466277,625506,2092832,8711480,948681,1738562,29650,565368,2721900,22638090,2569221,0,25207311,0,3790486,28997797,POINT (-91.8443207 42.8625919)
2022_38_GRUNDY_EXPEND_SA,2022,38,GRUNDY,2248562,540024,368300,1313120,6493667,542151,1988451,0,2284548,3928013,19706836,3365674,0,23072510,0,3687952,26760462,POINT (-92.7914177 42.4018651)
2005_42_HARDIN_EXPEND_SA,2005,42,HARDIN,2610966,280925,1672115,686604,3748107,298334,1040226,49430,561042,875000,11822749,2081659,,13904408,0,3841377,17745785,POINT (-93.2404025 42.3838803)
2012_87_TAYLOR_EXPEND_SA,2012,87,TAYLOR,897343,1068042,508295,417728,3084000,314653,648224,0,198038,5000,7141323,713584,0,7854907,0,1861898,9716805,POINT (-94.6964148 40.73743240000001)
2008_75_PLYMOUTH_EXPEND_SA,2008,75,PLYMOUTH,2708016,279582,1705500,866633,5612000,665248,2203025,0,946236,1334000,16320240,2724235,0,19044475,0,987545,20032020,POINT (-96.2140431 42.7378346)
2010_9_BREMER_EXPEND_SA,2010,9,BREMER,3168504,646548,2351786,1224542,3875280,674464,1749882,0,465061,2285629,16441696,1916750,0,18358446,0,7688032,26046478,POINT (-92.31805480000001 42.7745873)
2011_12_BUTLER_EXPEND_SA,2011,12,BUTLER,1909097,1541905,24063333,773635,4550000,464052,1534444,20000,38943,2545000,37440409,1558991,0,38999400,0,4300335,43299735,POINT (-92.7901934 42.7315661)
2022_77_POLK_EXPEND_SA,2022,77,POLK,88783002,42831147,18991222,21194547,12428855,9244694,41113515,0,23046088,19380356,277013426,71140712,0,348154138,0,104036521,452190659,POINT (-93.5735335 41.6855048)
2019_8_BOONE_EXPEND_SA,2019,8,BOONE,4079551,723885,796350,1251298,6621570,713822,2048695,0,658091,1272000,18165262,3230276,0,21395538,0,4444943,25840481,POINT (-93.931671 42.0365493)
2021_44_HENRY_EXPEND_SA,2021,44,HENRY,4732963,1618251,1172697,1162133,5074700,815793,1780708,68500,886100,1905715,19217560,1760722,0,20978282,0,2864719,23843001,POINT (-91.5445241 40.9879383)
2020_41_HANCOCK_EXPEND_SA,2020,41,HANCOCK,2086928,449902,399124,726793,6923429,598145,1551695,7500,0,930000,13673516,2475519,0,16149035,0,4413802,20562837,POINT (-93.7342723 43.0818861)
2006_36_FREMONT_EXPEND_SA,2006,36,FREMONT,1578567,235800,1216835,629839,3316440,486364,917384,6300,0,381000,8768529,811610,,9580139,0,2335057,11915196,POINT (-95.6046765 40.7455892)
2018_47_IDA_EXPEND_SA,2018,47,IDA,933710,299604,229605,470520,3796381,306319,814048,0,0,531400,7381587,1248456,0,8630043,0,1673708,10303751,POINT (-95.5134962 42.3868747)
2019_49_JACKSON_EXPEND_SA,2019,49,JACKSON,2494333,303750,395785,2129542,5926756,725197,2147587,0,0,1116858,15239808,1167700,0,16407508,0,7169652,23577160,POINT (-90.5742294 42.1717426)
2005_74_PALO ALTO_EXPEND_SA,2005,74,PALO ALTO,1195212,286440,1489500,897985,3474498,343576,1015113,0,10155,333710,9046189,1314704,,10360893,0,3200646,13561539,POINT (-94.6781371 43.0820643)
2006_30_DICKINSON_EXPEND_SA,2006,30,DICKINSON,1798865,520052,1386160,1239119,2629100,612735,1519813,52700,1305700,7607188,18671432,1585183,,20256615,0,7177675,27434290,POINT (-95.1508301 43.3779848)
2008_47_IDA_EXPEND_SA,2008,47,IDA,603863,239455,731891,853802,2242000,257390,750429,0,0,1110000,6788830,664897,0,7453727,0,1132173,8585900,POINT (-95.5134962 42.3868747)
2007_40_HAMILTON_EXPEND_SA,2007,40,HAMILTON,2233552,2153559,2108041,1148523,3892450,372000,1060583,0,521604,2380519,15870831,3701696,,19572527,0,2118586,21691113,POINT (-93.7068085 42.3837722)
2018_32_EMMET_EXPEND_SA,2018,32,EMMET,1967320,880374,556186,603846,3386583,519971,1397754,0,0,1276931,10588965,1075058,0,11664023,0,4688108,16352131,POINT (-94.6784803 43.37802250000001)
2006_7_BLACK HAWK_EXPEND_SA,2006,7,BLACK HAWK,15439040,10133567,18715043,2345579,4440773,1638168,4969155,0,2662215,2616909,62960449,1624582,,64585031,0,8046451,72631482,POINT (-92.3088197 42.4700957)
2007_47_IDA_EXPEND_SA,2007,47,IDA,588703,236127,699526,453126,2221000,251906,754377,0,0,400000,5604765,757190,,6361955,0,1945860,8307815,POINT (-95.5134962 42.3868747)
2017_15_CASS_EXPEND_SA,2017,15,CASS,2995252,529121,605935,644017,5633500,558869,1760525,2190325,281093,3156536,18355173,3521015,0,21876188,0,2738310,24614498,POINT (-94.9278266 41.3314876)
2013_1_ADAIR_EXPEND_SA,2013,1,ADAIR,1334347,295208,806550,485500,4201653,307325,781955,0,765450,1300000,10277988,1906959,0,12184947,0,3826518,16011465,POINT (-94.4709413 41.3307464)
2005_3_ALLAMAKEE_EXPEND_SA,2005,3,ALLAMAKEE,1136936,612740,1772029,564041,3513315,453358,806619,45215,0,1010000,9914253,1009050,,10923303,0,2522655,13445958,POINT (-91.3780923 43.2842838)
2015_97_WOODBURY_EXPEND_SA,2015,97,WOODBURY,14063336,5516778,5395411,2481277,7839500,2454960,6832579,20000,1114677,5315805,51034323,8674970,0,59709293,0,11300375,71009668,POINT (-96.0447673 42.3897169)
2014_48_IOWA_EXPEND_SA,2014,48,IOWA,3348849,1049086,729235,921860,5729575,591603,1544506,75708,1206744,215338,15412504,1286000,0,16698504,0,6677983,23376487,POINT (-92.065524 41.6863229)
2017_54_KEOKUK_EXPEND_SA,2017,54,KEOKUK,1273690,755016,307935,370899,5143350,413345,1907676,0,0,2113500,12285411,1714500,0,13999911,0,2982768,16982679,POINT (-92.1786426 41.336465)
2007_69_MONTGOMERY_EXPEND_SA,2007,69,MONTGOMERY,1545280,706398,937111,279741,2854426,372090,754025,200,64916,782584,8296771,879418,,9176189,0,1437843,10614032,POINT (-95.1563758 41.03014)
2011_40_HAMILTON_EXPEND_SA,2011,40,HAMILTON,2351936,1972014,2410197,1294634,4248750,439860,1229773,0,2502248,931504,17380916,2398486,0,19779402,0,3711929,23491331,POINT (-93.7068085 42.3837722)
2022_97_WOODBURY_EXPEND_SA,2022,97,WOODBURY,20052562,4917258,4322970,3751241,9589251,2663289,6854055,1251489,3701998,3942224,61046337,9983958,0,71030295,0,7749959,78780254,POINT (-96.0447673 42.3897169)
2008_64_MARSHALL_EXPEND_SA,2008,64,MARSHALL,5757023,933855,3590014,1008406,5679800,782090,2666246,0,696773,1712505,22826712,1494578,0,24321290,0,4570733,28892023,POINT (-92.9987706 42.0358499)
2013_14_CARROLL_EXPEND_SA,2013,14,CARROLL,3176382,1219844,3287715,1020335,5373475,621007,1550062,0,0,1031000,17279820,1718000,0,18997820,0,6411856,25409676,POINT (-94.8605593 42.0362382)
2007_8_BOONE_EXPEND_SA,2007,8,BOONE,2785828,747199,2441804,1093190,4995900,579593,1434649,0,417958,1552600,16048721,1958637,,18007358,0,2197555,20204913,POINT (-93.931671 42.0365493)
2010_14_CARROLL_EXPEND_SA,2010,14,CARROLL,2852694,1177753,2883408,1016673,4531460,463180,1473259,430000,87904,1010400,15926731,1289000,0,17215731,0,5064008,22279739,POINT (-94.8605593 42.0362382)
2008_15_CASS_EXPEND_SA,2008,15,CASS,2131231,508192,2293233,587767,3847000,430906,1114845,122015,0,6426785,17461974,4974132,0,22436106,0,671222,23107328,POINT (-94.9278266 41.3314876)
2022_13_CALHOUN_EXPEND_SA,2022,13,CALHOUN,5119928,1394211,543556,1668266,6105000,550903,1812929,604538,0,4140340,21939671,1841936,0,23781607,0,3154016,26935623,POINT (-94.6404136 42.385184800000005)
2014_31_DUBUQUE_EXPEND_SA,2014,31,DUBUQUE,13542139,12924795,4423213,3032285,7833674,1350236,3424342,821718,570564,10264369,58187335,6482787,0,64670122,0,14913452,79583574,POINT (-90.8824564 42.468832)
2010_47_IDA_EXPEND_SA,2010,47,IDA,666528,296972,725782,366383,2420000,271579,1049466,0,0,260000,6056710,825000,0,6881710,0,1909768,8791478,POINT (-95.5134962 42.3868747)
2020_79_POWESHIEK_EXPEND_SA,2020,79,POWESHIEK,3415002,358288,459328,656967,7089947,686123,1344434,419200,744720,2485743,17659752,2855688,0,20515440,0,9117882,29633322,POINT (-92.53146840000001 41.6864422)
2011_64_MARSHALL_EXPEND_SA,2011,64,MARSHALL,6754560,1028668,4069374,988405,5929300,853060,2606409,0,619803,2350075,25199654,2045550,0,27245204,0,4924938,32170142,POINT (-92.9987706 42.0358499)
2012_73_PAGE_EXPEND_SA,2012,73,PAGE,1684703,673951,1975315,410263,3392120,464909,1130948,4000,209050,543000,10488259,1016089,0,11504348,0,3455872,14960220,POINT (-95.1501747 40.7391444)
2022_30_DICKINSON_EXPEND_SA,2022,30,DICKINSON,3346190,679224,526196,8528897,5330960,942566,2744611,111300,1416758,2577500,26204202,5030815,0,31235017,0,9862917,41097934,POINT (-95.1508301 43.3779848)
2015_65_MILLS_EXPEND_SA,2015,65,MILLS,3143986,1635856,2123107,1702123,5270670,551516,1491177,0,535436,3068899,19522770,2196815,0,21719585,0,2693716,24413301,POINT (-95.62132670000001 41.0334523)
2016_82_SCOTT_EXPEND_SA,2016,82,SCOTT,29301561,5962415,7918096,5080532,5991000,2535390,10963015,0,3608943,9414835,80775787,11247067,0,92022854,0,22760518,114783372,POINT (-90.6232428 41.6370978)
2017_99_WRIGHT_EXPEND_SA,2017,99,WRIGHT,2579876,3190679,1020750,1255925,5486250,578942,1571350,31992,367116,1490000,17572880,1841021,0,19413901,0,3209923,22623824,POINT (-93.7351465 42.7331189)
2009_3_ALLAMAKEE_EXPEND_SA,2009,3,ALLAMAKEE,1336640,648613,2052946,838699,4314008,418805,971012,58118,0,675000,11313841,1350129,0,12663970,0,3228532,15892502,POINT (-91.3780923 43.2842838)
2015_46_HUMBOLDT_EXPEND_SA,2015,46,HUMBOLDT,1756596,402873,939348,779056,3201448,396221,1194854,0,0,369000,9039396,1617597,0,10656993,0,4950136,15607129,POINT (-94.2071868 42.7764686)
2019_81_SAC_EXPEND_SA,2019,81,SAC,3032861,895768,237024,1147160,5376875,500859,1547779,0,0,1319500,14057826,1573686,0,15631512,0,3887363,19518875,POINT (-95.1053946 42.3862604)
2010_64_MARSHALL_EXPEND_SA,2010,64,MARSHALL,6514488,977630,4110506,1023169,5992900,890855,2742234,0,580503,1802775,24635060,1860000,0,26495060,0,4627102,31122162,POINT (-92.9987706 42.0358499)
2015_82_SCOTT_EXPEND_SA,2015,82,SCOTT,28877355,5906630,8431294,4811586,7253000,2365682,10956284,0,4081305,6984935,79668071,11613870,0,91281941,0,20988392,112270333,POINT (-90.6232428 41.6370978)
2016_99_WRIGHT_EXPEND_SA,2016,99,WRIGHT,2377004,4025586,1002198,1194239,5176650,594249,1521183,33600,354495,310000,16589204,1818075,0,18407279,0,3435007,21842286,POINT (-93.7351465 42.7331189)
2011_81_SAC_EXPEND_SA,2011,81,SAC,2022704,587317,1533314,740593,3694700,356878,1196798,0,55000,525000,10712304,1133915,0,11846219,0,1733926,13580145,POINT (-95.1053946 42.3862604)
2021_80_RINGGOLD_EXPEND_SA,2021,80,RINGGOLD,1599900,1011094,553717,460083,3394229,303244,990094,0,183450,1762263,10258074,850000,0,11108074,0,4002522,15110596,POINT (-94.2439719 40.7352023)
2020_31_DUBUQUE_EXPEND_SA,2020,31,DUBUQUE,16821714,5689729,3450862,4112566,11018755,2249672,4820284,1926576,3062120,11003897,64156175,7203969,0,71360144,0,21316670,92676814,POINT (-90.8824564 42.468832)
2015_37_GREENE_EXPEND_SA,2015,37,GREENE,1458450,466135,383593,768229,4399339,361260,1571556,60000,0,80000,9548562,1190000,0,10738562,0,3463334,14201896,POINT (-94.3968356 42.0362394)
2016_79_POWESHIEK_EXPEND_SA,2016,79,POWESHIEK,3064089,398937,746416,495302,6176645,704171,1289434,107000,841138,782500,14605632,2264398,0,16870030,0,5731803,22601833,POINT (-92.53146840000001 41.6864422)
2021_33_FAYETTE_EXPEND_SA,2021,33,FAYETTE,4492834,460378,624812,2069756,10227930,896359,1734419,29650,568112,7925835,29030085,5838157,0,34868242,0,3317218,38185460,POINT (-91.8443207 42.8625919)
2010_36_FREMONT_EXPEND_SA,2010,36,FREMONT,1940977,209841,1217597,676974,3435010,391024,1313647,2300,144740,400000,9732110,855661,0,10587771,0,3297833,13885604,POINT (-95.6046765 40.7455892)
2014_63_MARION_EXPEND_SA,2014,63,MARION,3766212,2544232,1454070,1450981,6162132,855317,2496683,0,523462,845000,20098089,2423006,0,22521095,0,9844062,32365157,POINT (-93.0994367 41.3344515)
2016_97_WOODBURY_EXPEND_SA,2016,97,WOODBURY,15560589,5065312,4780782,2550200,8255200,2485217,6222595,20000,1069776,5569177,51578848,8753047,0,60331895,0,13282536,73614431,POINT (-96.0447673 42.3897169)
2012_81_SAC_EXPEND_SA,2012,81,SAC,2106317,598606,1519853,737816,4058900,382381,1181758,0,55000,363000,11003631,1250669,0,12254300,0,2721287,14975587,POINT (-95.1053946 42.3862604)
2013_3_ALLAMAKEE_EXPEND_SA,2013,3,ALLAMAKEE,1634209,717659,2244472,1504650,5176997,436130,919964,323700,0,6177495,19135276,1530014,0,20665290,0,1519363,22184653,POINT (-91.3780923 43.2842838)
2010_92_WASHINGTON_EXPEND_SA,2010,92,WASHINGTON,4267967,2453616,2265632,786956,4573332,670828,1839629,54700,2525240,505300,19943200,1793328,0,21736528,0,3726290,25462818,POINT (-91.7178676 41.335591)
2011_69_MONTGOMERY_EXPEND_SA,2011,69,MONTGOMERY,1974919,700484,1219948,294007,3349887,426437,789127,200,25928,579734,9360671,989784,0,10350455,0,2505502,12855957,POINT (-95.1563758 41.03014)
2012_26_DAVIS_EXPEND_SA,2012,26,DAVIS,1038359,330497,667738,328831,2908914,357100,896507,20000,75410,300000,6923356,612436,0,7535792,0,3072095,10607887,POINT (-92.4097173 40.7476891)
2013_97_WOODBURY_EXPEND_SA,2013,97,WOODBURY,13337361,5924139,12445191,2389710,7245230,2418911,6169194,626401,1116175,2960200,54632512,6240476,0,60872988,0,6854949,67727937,POINT (-96.0447673 42.3897169)
2022_50_JASPER_EXPEND_SA,2022,50,JASPER,7988258,1922520,576300,1703973,8092922,1643505,3929331,31458,1398191,7285600,34572058,6073545,0,40645603,0,16586829,57232432,POINT (-93.053765 41.6860394)
2014_36_FREMONT_EXPEND_SA,2014,36,FREMONT,1796063,304442,626143,686592,3768000,416484,1310006,1500,107948,495000,9512178,1057558,0,10569736,0,4448662,15018398,POINT (-95.6046765 40.7455892)
2014_16_CEDAR_EXPEND_SA,2014,16,CEDAR,3333360,1478846,1193424,1354713,5223582,557468,1595408,5100,0,1458900,16200801,1966595,0,18167396,0,2191796,20359192,POINT (-91.1324125 41.7723207)
2017_91_WARREN_EXPEND_SA,2017,91,WARREN,5167220,3496795,1112967,1554894,6768059,1012627,2852601,0,94335,1740000,23799498,3250000,0,27049498,0,9699298,36748796,POINT (-93.5613594 41.3343735)
2008_2_ADAMS_EXPEND_SA,2008,2,ADAMS,767504,534415,463575,427546,2808700,208315,592704,44572,74811,462500,6384642,623731,0,7008373,0,1754926,8763299,POINT (-94.6991849 41.02898390000001)
2016_47_IDA_EXPEND_SA,2016,47,IDA,793065,329623,249935,402026,3531390,278073,767218,0,0,685000,7036330,1112523,0,8148853,0,2060336,10209189,POINT (-95.5134962 42.3868747)
2021_65_MILLS_EXPEND_SA,2021,65,MILLS,4323188,1842272,376575,1722642,9011502,737212,6348939,0,1207362,263000,25832692,3037122,0,28869814,0,7228434,36098248,POINT (-95.62132670000001 41.0334523)
2009_17_CERRO GORDO_EXPEND_SA,2009,17,CERRO GORDO,7151260,5372186,6530000,1389880,5172514,1021417,2525567,20500,1059218,2320000,32562542,2698116,0,35260658,0,8467843,43728501,POINT (-93.2608184 43.081557700000005)
2014_75_PLYMOUTH_EXPEND_SA,2014,75,PLYMOUTH,3291486,358888,1181338,943804,7463000,788192,4208974,0,1717335,4079945,24032962,3820000,0,27852962,0,2493682,30346644,POINT (-96.2140431 42.7378346)
2012_58_LOUISA_EXPEND_SA,2012,58,LOUISA,2426741,648311,1398998,2658998,3188763,310444,986098,0,359320,765183,12742856,1977081,0,14719937,0,3614607,18334544,POINT (-91.2596184 41.2185073)
2022_45_HOWARD_EXPEND_SA,2022,45,HOWARD,2433972,468468,366436,2490281,5412850,514389,1451583,5000,1079108,138349,14360436,2125179,0,16485615,0,4874914,21360529,POINT (-92.3171989 43.3567673)
2020_26_DAVIS_EXPEND_SA,2020,26,DAVIS,1829110,379989,533930,469353,4486115,439457,1168121,30539,402415,1640000,11379029,951090,0,12330119,0,2618876,14948995,POINT (-92.4097173 40.7476891)
2017_64_MARSHALL_EXPEND_SA,2017,64,MARSHALL,8031878,820948,953400,1186051,6593400,1152177,2979105,0,750000,1412827,23879786,2532000,0,26411786,0,8304984,34716770,POINT (-92.9987706 42.0358499)
2011_25_DALLAS_EXPEND_SA,2011,25,DALLAS,7925575,2895024,4256303,3155323,6850558,1724755,1753417,33000,1668343,4379000,34641298,6607807,0,41249105,0,15626221,56875326,POINT (-94.0397374 41.6848862)
2022_82_SCOTT_EXPEND_SA,2022,82,SCOTT,37547515,6926476,5566422,5521404,8334600,3165502,13549075,0,4848149,8224287,93683430,15214555,0,108897985,0,26952798,135850783,POINT (-90.6232428 41.6370978)
2009_30_DICKINSON_EXPEND_SA,2009,30,DICKINSON,2252770,522480,1325061,2168456,3508726,599200,1888334,117000,1879292,2016285,16277604,3175767,0,19453371,0,6746686,26200057,POINT (-95.1508301 43.3779848)
2010_19_CHICKASAW_EXPEND_SA,2010,19,CHICKASAW,1378425,1350177,1165273,503703,3995600,438553,1392112,0,0,331350,10555193,2121200,0,12676393,0,4323219,16999612,POINT (-92.3176637 43.06004140000001)
2016_58_LOUISA_EXPEND_SA,2016,58,LOUISA,2893724,790342,651691,659310,3269495,372906,1139257,0,357348,2038507,12172580,1718062,0,13890642,0,4912291,18802933,POINT (-91.2596184 41.2185073)
2022_72_OSCEOLA_EXPEND_SA,2022,72,OSCEOLA,1837545,290471,76791,719785,3955148,339782,1291937,153537,344975,566000,9575971,1802430,0,11378401,0,4883059,16261460,POINT (-95.6236852 43.3785704)
2009_35_FRANKLIN_EXPEND_SA,2009,35,FRANKLIN,1453655,1700066,1269365,734598,3731000,369896,1616423,0,444000,929000,12248003,1373221,0,13621224,0,3516977,17138201,POINT (-93.262473 42.7325458)
2021_97_WOODBURY_EXPEND_SA,2021,97,WOODBURY,20383357,5513589,4204473,3726685,10704041,2675917,7316088,1216565,1604883,3599066,60944664,9771696,0,70716360,0,9596722,80313082,POINT (-96.0447673 42.3897169)
2022_16_CEDAR_EXPEND_SA,2022,16,CEDAR,4657267,1460960,739270,1933681,7181500,609772,2244340,8400,709619,8869259,28414068,2778821,0,31192889,0,8801598,39994487,POINT (-91.1324125 41.7723207)
2016_15_CASS_EXPEND_SA,2016,15,CASS,3028072,1066063,519541,554435,5133500,598358,1681163,3174343,141465,1942254,17839194,3523142,0,21362336,0,2019172,23381508,POINT (-94.9278266 41.3314876)
2017_32_EMMET_EXPEND_SA,2017,32,EMMET,1966404,864967,463489,545253,3234174,491424,1377154,0,0,99546,9042411,1040969,0,10083380,0,3680283,13763663,POINT (-94.6784803 43.37802250000001)
2013_33_FAYETTE_EXPEND_SA,2013,33,FAYETTE,3111552,541638,2951592,1494159,5215850,717219,1374870,238800,359275,628800,16633755,1722228,0,18355983,0,2037830,20393813,POINT (-91.8443207 42.8625919)
2006_68_MONROE_EXPEND_SA,2006,68,MONROE,1149770,735262,957066,279416,2242422,398600,926847,0,270957,1975777,8936117,826053,,9762170,0,2231714,11993884,POINT (-92.8689877 41.0297826)
2019_98_WORTH_EXPEND_SA,2019,98,WORTH,2366720,1096070,343229,987200,4378731,444013,1562858,0,2372735,3310634,16862190,1183884,0,18046074,0,6281237,24327311,POINT (-93.2608476 43.3773984)
2005_33_FAYETTE_EXPEND_SA,2005,33,FAYETTE,2361508,538368,2374076,1175370,3931850,485259,1000986,34600,350198,1280300,13532515,1076224,,14608739,0,1235770,15844509,POINT (-91.8443207 42.8625919)
2005_35_FRANKLIN_EXPEND_SA,2005,35,FRANKLIN,1180797,1410064,1148478,473228,2979000,315986,1352535,0,525884,849500,10235472,957424,,11192896,0,3177010,14369906,POINT (-93.262473 42.7325458)
2017_86_TAMA_EXPEND_SA,2017,86,TAMA,3998394,1680525,985855,1130369,7920376,537574,1576639,36750,349810,1439911,19656203,2150000,0,21806203,0,4893893,26700096,POINT (-92.5325425 42.07981170000001)
2006_50_JASPER_EXPEND_SA,2006,50,JASPER,3765372,1900365,4082203,1059570,5596545,978694,2229021,500,970195,5089655,25672120,2250099,,27922219,0,4608474,32530693,POINT (-93.053765 41.6860394)
2022_65_MILLS_EXPEND_SA,2022,65,MILLS,4732511,1967766,347507,17254026,7038225,739277,5374550,0,1128388,586000,39168250,3081414,0,42249664,0,5662345,47912009,POINT (-95.62132670000001 41.0334523)
2007_67_MONONA_EXPEND_SA,2007,67,MONONA,1453926,742108,874651,474961,3485662,364694,1327171,0,52270,650000,9425443,775000,,10200443,0,2486235,12686678,POINT (-95.9599235 42.0516663)
2020_64_MARSHALL_EXPEND_SA,2020,64,MARSHALL,9643746,757768,1051000,1144751,7960500,996893,2966813,0,31000,23237565,47790036,5703500,0,53493536,0,8820263,62313799,POINT (-92.9987706 42.0358499)
2005_46_HUMBOLDT_EXPEND_SA,2005,46,HUMBOLDT,1268897,323339,1226586,543499,2625157,361298,955919,27244,0,491000,7822939,1050239,,8873178,0,3034413,11907591,POINT (-94.2071868 42.7764686)
2013_65_MILLS_EXPEND_SA,2013,65,MILLS,2811713,2058364,1713080,1233725,5473665,496704,2853857,0,106170,398000,17145278,1954607,0,19099885,0,2999041,22098926,POINT (-95.62132670000001 41.0334523)
2006_63_MARION_EXPEND_SA,2006,63,MARION,2314928,2358161,2789049,1085012,5303372,806868,1884746,0,585000,5820000,22947136,1649846,,24596982,0,2898411,27495393,POINT (-93.0994367 41.3344515)
2012_53_JONES_EXPEND_SA,2012,53,JONES,2330541,882886,2602449,827125,6119360,614050,1617215,39966,32052,2400000,17465644,1882500,0,19348144,0,2253101,21601245,POINT (-91.1314352 42.1212397)
2007_82_SCOTT_EXPEND_SA,2007,82,SCOTT,21739952,5806716,14236281,3860822,4385500,1885195,7912588,0,1391039,7536700,68754793,8402679,,77157472,0,13914496,91071968,POINT (-90.6232428 41.6370978)
2005_65_MILLS_EXPEND_SA,2005,65,MILLS,1989301,1696134,1421352,629532,4351850,416501,959052,0,0,1000000,12463722,1132500,,13596222,0,844436,14440658,POINT (-95.62132670000001 41.0334523)
2018_15_CASS_EXPEND_SA,2018,15,CASS,3251102,581427,509017,699856,6075000,552996,1495357,1166625,169275,3400855,17901510,3516992,0,21418502,0,4099938,25518440,POINT (-94.9278266 41.3314876)
2021_12_BUTLER_EXPEND_SA,2021,12,BUTLER,2746709,1457041,436170,1770343,6715000,662685,2421484,2500,1012180,2785000,20009112,3866724,0,23875836,0,3873495,27749331,POINT (-92.7901934 42.7315661)
2010_79_POWESHIEK_EXPEND_SA,2010,79,POWESHIEK,2501938,417339,1737203,949257,4692800,729248,1130144,212693,603920,5927330,18901872,1887370,0,20789242,0,4080562,24869804,POINT (-92.53146840000001 41.6864422)
2006_82_SCOTT_EXPEND_SA,2006,82,SCOTT,20289443,5752400,13535864,3721731,4129000,1892398,7343224,0,1382609,5485530,63532199,8497603,,72029802,0,17224997,89254799,POINT (-90.6232428 41.6370978)
2011_96_WINNESHIEK_EXPEND_SA,2011,96,WINNESHIEK,2257607,1700154,2389801,1410630,5414275,407112,1800570,5400,492025,2370817,18248391,2061209,0,20309600,0,3402973,23712573,POINT (-91.8437074 43.2906746)
2007_99_WRIGHT_EXPEND_SA,2007,99,WRIGHT,1548773,3080707,1574874,944139,3605000,430179,1031144,37377,288982,785000,13326175,1193222,,14519397,0,2574441,17093838,POINT (-93.7351465 42.7331189)
2005_18_CHEROKEE_EXPEND_SA,2005,18,CHEROKEE,1450154,717141,1054370,457721,2828400,258079,888969,0,0,2200000,9854834,1008000,,10862834,0,2874545,13737379,POINT (-95.6238055 42.7356226)
2009_49_JACKSON_EXPEND_SA,2009,49,JACKSON,1555998,493337,2490268,1030658,4039038,573115,1384544,111100,16737,178321,11873116,1366500,0,13239616,0,4292092,17531708,POINT (-90.5742294 42.1717426)
2018_88_UNION_EXPEND_SA,2018,88,UNION,1862366,501376,496156,3638972,3758993,619981,1009782,0,834723,235000,12957349,1131123,0,14088472,0,2713058,16801530,POINT (-94.2423792 41.0277304)
2006_51_JEFFERSON_EXPEND_SA,2006,51,JEFFERSON,2375214,571045,1234524,504397,2525000,480744,852644,0,3572220,376000,12491788,792754,,13284542,0,2915725,16200267,POINT (-91.9488774 41.0317596)
2021_48_IOWA_EXPEND_SA,2021,48,IOWA,5787872,1482633,638487,1109015,7111824,777698,4918229,147572,758790,1827000,24559120,1315000,0,25874120,0,6417602,32291722,POINT (-92.065524 41.6863229)
2008_79_POWESHIEK_EXPEND_SA,2008,79,POWESHIEK,2093750,427127,1803670,763550,4470000,745288,1185484,230693,201718,1780000,13701280,1266838,0,14968118,0,3763532,18731650,POINT (-92.53146840000001 41.6864422)
2012_41_HANCOCK_EXPEND_SA,2012,41,HANCOCK,1427597,1487731,1549000,510651,4839800,350059,936559,1700,0,632000,11735097,2015000,0,13750097,0,3952797,17702894,POINT (-93.7342723 43.0818861)
2011_8_BOONE_EXPEND_SA,2011,8,BOONE,3263186,758889,2715225,3189768,5558250,642030,1809877,0,1140844,1307300,20385369,2135363,0,22520732,0,3073342,25594074,POINT (-93.931671 42.0365493)
2010_90_WAPELLO_EXPEND_SA,2010,90,WAPELLO,3492487,1632660,5338192,942264,3640676,584009,2682610,135036,300666,1012500,19761100,1000000,0,20761100,0,6191667,26952767,POINT (-92.4094499 41.03058450000001)
2016_66_MITCHELL_EXPEND_SA,2016,66,MITCHELL,1714030,1806654,679852,1703855,3850000,369841,1418965,0,4515612,2600000,18658809,1404625,0,20063434,0,2401879,22465313,POINT (-92.7890315 43.3564124)
2013_28_DELAWARE_EXPEND_SA,2013,28,DELAWARE,2283212,704474,3205866,875029,4707225,681860,1340681,32400,72400,2932092,16835239,1931367,0,18766606,0,3752662,22519268,POINT (-91.3673502 42.471211)
2010_68_MONROE_EXPEND_SA,2010,68,MONROE,1309997,859792,1017640,319830,2614634,393985,1033705,0,162375,889500,8601458,924062,0,9525520,0,999144,10524664,POINT (-92.8689877 41.0297826)
2014_14_CARROLL_EXPEND_SA,2014,14,CARROLL,3329117,1174526,1305389,1014942,5224100,522107,1665182,0,0,1169001,15404364,2157000,0,17561364,0,6972693,24534057,POINT (-94.8605593 42.0362382)
2014_85_STORY_EXPEND_SA,2014,85,STORY,10198358,2277887,6789252,2868985,5513200,1206202,4955659,0,2248401,1301510,37359454,2307000,0,39666454,0,9163012,48829466,POINT (-93.4650448 42.0362415)
2006_78_POTTAWATTAMIE_EXPEND_SA,2006,78,POTTAWATTAMIE,15190712,2996267,7638619,3941075,9814260,1629079,5819421,0,1623891,5314033,53967357,4010944,,57978301,0,7617615,65595916,POINT (-95.5423935 41.3366123)
2009_28_DELAWARE_EXPEND_SA,2009,28,DELAWARE,1917692,532569,2707741,753267,3812000,543684,1138708,25960,0,1886700,13318321,1653183,0,14971504,0,1378104,16349608,POINT (-91.3673502 42.471211)
2015_18_CHEROKEE_EXPEND_SA,2015,18,CHEROKEE,2250790,370065,785879,921233,4664810,511582,1486483,0,0,2555500,13546342,1783500,0,15329842,0,4884494,20214336,POINT (-95.6238055 42.7356226)
2012_2_ADAMS_EXPEND_SA,2012,2,ADAMS,1027158,295629,547070,585081,2896000,233610,719844,32266,462350,35500,6834508,770302,0,7604810,0,2710259,10315069,POINT (-94.6991849 41.02898390000001)
2006_93_WAYNE_EXPEND_SA,2006,93,WAYNE,749310,610831,756159,309433,2537868,263147,633998,43750,0,209000,6113496,501484,,6614980,0,532596,7147576,POINT (-93.3273639 40.73947020000001)
2009_7_BLACK HAWK_EXPEND_SA,2009,7,BLACK HAWK,16161254,11919503,22200918,2777624,5477582,1725319,5253463,0,3848899,17646935,87011497,1981474,0,88992971,0,9768540,98761511,POINT (-92.3088197 42.4700957)
2012_40_HAMILTON_EXPEND_SA,2012,40,HAMILTON,2615187,2065214,2465394,1271999,4572650,490823,1304957,0,2510066,870985,18167275,2446558,0,20613833,0,3341458,23955291,POINT (-93.7068085 42.3837722)
2005_23_CLINTON_EXPEND_SA,2005,23,CLINTON,4999878,1302565,7024889,1154447,4800970,981426,2263242,100000,0,918841,23546258,704132,,24250390,0,3263587,27513977,POINT (-90.5319724 41.8980358)
2021_32_EMMET_EXPEND_SA,2021,32,EMMET,2263825,806022,303520,601072,3781070,598475,1477886,0,0,26000,9857870,1101141,0,10959011,0,4461435,15420446,POINT (-94.6784803 43.37802250000001)
2019_4_APPANOOSE_EXPEND_SA,2019,4,APPANOOSE,2871874,537286,721755,788632,3779609,555679,1100691,0,116111,1113754,11585391,665110,0,12250501,0,5492609,17743110,POINT (-92.8686104 40.7431635)
2005_45_HOWARD_EXPEND_SA,2005,45,HOWARD,927717,509128,1019700,901188,2424171,224854,679907,1000,30408,427463,7145536,834000,,7979536,0,1563131,9542667,POINT (-92.3171989 43.3567673)
2013_52_JOHNSON_EXPEND_SA,2013,52,JOHNSON,21922873,8609285,14039460,3565692,8400949,2418888,7615331,3000,4701920,12931175,84208573,22636534,0,106845107,0,19380633,126225740,POINT (-91.5880849 41.6715511)
2016_37_GREENE_EXPEND_SA,2016,37,GREENE,1624870,460351,465319,1063821,4881706,374719,1629606,235000,0,434300,11169692,1255000,0,12424692,0,3544377,15969069,POINT (-94.3968356 42.0362394)
2012_80_RINGGOLD_EXPEND_SA,2012,80,RINGGOLD,1087590,1021764,955213,245743,2844397,290962,1580302,22700,250000,308000,8606671,648258,0,9254929,0,2279394,11534323,POINT (-94.2439719 40.7352023)
2021_37_GREENE_EXPEND_SA,2021,37,GREENE,2718663,580385,301129,1149793,5993800,412830,2145875,110000,150000,2797000,16359475,1860100,0,18219575,0,3344635,21564210,POINT (-94.3968356 42.0362394)
2007_89_VAN BUREN_EXPEND_SA,2007,89,VAN BUREN,944619,373280,572346,372323,2735000,269127,557571,3500,0,730000,6557766,465448,,7023214,0,1637277,8660491,POINT (-91.9499871 40.7532294)
2022_70_MUSCATINE_EXPEND_SA,2022,70,MUSCATINE,13380404,1462506,1270637,1582412,7842000,1023459,3647798,0,2325984,4276550,36811750,2539170,0,39350920,0,16956892,56307812,POINT (-91.1127562 41.4839221)
2021_69_MONTGOMERY_EXPEND_SA,2021,69,MONTGOMERY,3606095,512125,250075,420341,4484321,498573,1221968,0,1253143,2200000,14446641,1095850,0,15542491,0,2463981,18006472,POINT (-95.1563758 41.03014)
2019_3_ALLAMAKEE_EXPEND_SA,2019,3,ALLAMAKEE,2620725,713573,694836,1146293,6437435,552694,1223975,17000,420500,1400000,15227031,2010000,0,17237031,0,2534008,19771039,POINT (-91.3780923 43.2842838)
2012_51_JEFFERSON_EXPEND_SA,2012,51,JEFFERSON,2806625,725906,1210018,727995,2990000,527053,986489,0,197965,577500,10749551,1000000,0,11749551,0,2570942,14320493,POINT (-91.9488774 41.0317596)
2013_84_SIOUX_EXPEND_SA,2013,84,SIOUX,4252921,1507368,2762316,1138144,5715960,910832,2215102,37000,888625,9849800,29278068,3015550,0,32293618,0,-737817,31555801,POINT (-96.1778827 43.0826174)
2013_35_FRANKLIN_EXPEND_SA,2013,35,FRANKLIN,1608122,1993696,1377773,817278,4408036,497144,1774197,0,908758,1331334,14716338,1551126,0,16267464,0,4765914,21033378,POINT (-93.262473 42.7325458)
2010_83_SHELBY_EXPEND_SA,2010,83,SHELBY,1783678,529616,2378090,406241,4308550,426627,1049758,0,266796,1043196,12192552,2322105,0,14514657,0,3352793,17867450,POINT (-95.31021130000002 41.6850926)
2012_19_CHICKASAW_EXPEND_SA,2012,19,CHICKASAW,1483931,1411252,1242770,763432,4366433,379782,1190938,0,0,1284664,12123202,2206208,0,14329410,0,4871669,19201079,POINT (-92.3176637 43.06004140000001)
2010_85_STORY_EXPEND_SA,2010,85,STORY,8713194,1958834,8715388,2538842,5115950,1169736,4533558,0,2227430,5375000,40347932,2000000,0,42347932,0,5960398,48308330,POINT (-93.4650448 42.0362415)
2007_94_WEBSTER_EXPEND_SA,2007,94,WEBSTER,4554212,2203150,4056463,1088603,5970000,792550,2489036,580000,381605,1800000,23915619,1950000,,25865619,0,7645248,33510867,POINT (-94.18178810000002 42.4279662)
2020_51_JEFFERSON_EXPEND_SA,2020,51,JEFFERSON,3509002,932722,672255,873336,4249000,663340,1433065,0,922833,10004193,23259746,1000000,0,24259746,0,3762726,28022472,POINT (-91.9488774 41.0317596)
2014_68_MONROE_EXPEND_SA,2014,68,MONROE,1534991,904398,449268,445627,2565377,435600,1201276,0,336912,640500,8513949,1043848,0,9557797,0,1648886,11206683,POINT (-92.8689877 41.0297826)
2019_18_CHEROKEE_EXPEND_SA,2019,18,CHEROKEE,2519516,368313,364992,1000756,6458600,588446,1610281,0,0,1340753,14251657,1937575,0,16189232,0,7219455,23408687,POINT (-95.6238055 42.7356226)
2005_60_LYON_EXPEND_SA,2005,60,LYON,1766485,605052,813168,425535,2818210,352730,786228,125000,275175,635000,8602583,865000,,9467583,0,3114214,12581797,POINT (-96.2102924 43.380497)
2006_20_CLARKE_EXPEND_SA,2006,20,CLARKE,1308921,902106,949206,258966,2184800,411161,726719,0,626540,145800,7514219,534819,,8049038,0,3273999,11323037,POINT (-93.78515790000002 41.0290323)
2022_19_CHICKASAW_EXPEND_SA,2022,19,CHICKASAW,2460725,1523711,357990,742630,6230775,585260,1847639,0,479360,551258,14779348,1742140,0,16521488,0,4553225,21074713,POINT (-92.3176637 43.06004140000001)
2020_36_FREMONT_EXPEND_SA,2020,36,FREMONT,3172902,304411,173700,510174,4399000,529345,2146620,10000,677005,468000,12391157,1381335,0,13772492,0,3132267,16904759,POINT (-95.6046765 40.7455892)
2016_36_FREMONT_EXPEND_SA,2016,36,FREMONT,2094926,279679,501485,661505,3979000,475071,1413353,1500,464299,775000,10645818,1233191,0,11879009,0,8397336,20276345,POINT (-95.6046765 40.7455892)
2007_84_SIOUX_EXPEND_SA,2007,84,SIOUX,3256295,1611148,2558289,699926,4998400,810457,1835395,47750,479016,3186275,19482951,1584257,,21067208,0,-54413,21012795,POINT (-96.1778827 43.0826174)
2007_7_BLACK HAWK_EXPEND_SA,2007,7,BLACK HAWK,15219649,10834294,20381105,2494010,4769361,1620442,4993769,0,2536412,4295103,67144145,1699851,,68843996,0,5309549,74153545,POINT (-92.3088197 42.4700957)
2017_69_MONTGOMERY_EXPEND_SA,2017,69,MONTGOMERY,3014680,661134,403694,393164,4135195,480843,2084153,200,408210,85158,11666431,867000,0,12533431,0,4083223,16616654,POINT (-95.1563758 41.03014)
2017_39_GUTHRIE_EXPEND_SA,2017,39,GUTHRIE,1748968,1463124,321994,1350146,5128166,420548,1120538,2000,479941,7975000,20010425,1729541,0,21739966,0,4772928,26512894,POINT (-94.501055 41.6837548)
2010_51_JEFFERSON_EXPEND_SA,2010,51,JEFFERSON,2748595,679962,1352708,988745,2775000,491463,776252,0,181058,970000,10963783,902661,0,11866444,0,2838617,14705061,POINT (-91.9488774 41.0317596)
2020_4_APPANOOSE_EXPEND_SA,2020,4,APPANOOSE,3000427,520480,734933,899759,4126671,574766,1123910,0,102320,1133754,12217020,686786,0,12903806,0,4879230,17783036,POINT (-92.8686104 40.7431635)
2007_62_MAHASKA_EXPEND_SA,2007,62,MAHASKA,2528879,881091,2315547,642356,4380000,559059,1215862,737400,0,1015000,14275194,1395402,,15670596,0,11846688,27517284,POINT (-92.6409094 41.3352035)
2005_28_DELAWARE_EXPEND_SA,2005,28,DELAWARE,1452037,420177,2045841,579787,4042500,403738,913375,11947,0,2341628,12211030,1241700,,13452730,0,1342411,14795141,POINT (-91.3673502 42.471211)
2009_18_CHEROKEE_EXPEND_SA,2009,18,CHEROKEE,1573145,302223,1448721,664197,3434363,470058,1453135,0,0,2015000,11360842,1134000,0,12494842,0,2525975,15020817,POINT (-95.6238055 42.7356226)
2011_48_IOWA_EXPEND_SA,2011,48,IOWA,2728548,920807,1425090,828046,5650184,497470,1427617,93110,636186,864119,15071177,1396725,0,16467902,0,3348069,19815971,POINT (-92.065524 41.6863229)
2019_43_HARRISON_EXPEND_SA,2019,43,HARRISON,3060515,1833439,297129,1226171,6070000,587108,1556718,0,119075,1762000,16512155,2213000,0,18725155,0,8735641,27460796,POINT (-95.8169209 41.6828528)
2005_72_OSCEOLA_EXPEND_SA,2005,72,OSCEOLA,809771,149397,559500,271496,1915000,183695,596777,0,0,280000,4765636,544311,,5309947,0,2054636,7364583,POINT (-95.6236852 43.3785704)
2008_95_WINNEBAGO_EXPEND_SA,2008,95,WINNEBAGO,1262011,693952,1298380,541777,3058000,422407,900661,169912,156800,600500,9104400,1557409,0,10661809,0,1315347,11977156,POINT (-93.7341955 43.37756780000001)
2016_51_JEFFERSON_EXPEND_SA,2016,51,JEFFERSON,2988592,924680,607300,676379,3717800,516531,1093468,10000,254700,362500,11151950,1151333,0,12303283,0,2895216,15198499,POINT (-91.9488774 41.0317596)
2020_19_CHICKASAW_EXPEND_SA,2020,19,CHICKASAW,2356135,1536703,508152,685307,5714735,493892,1667718,0,522548,4010511,17495701,2155287,0,19650988,0,4078375,23729363,POINT (-92.3176637 43.06004140000001)
2005_13_CALHOUN_EXPEND_SA,2005,13,CALHOUN,1259812,3679956,1003578,612855,3210395,346007,946558,8125,0,551750,11619036,966460,,12585496,0,2925477,15510973,POINT (-94.6404136 42.385184800000005)
2021_86_TAMA_EXPEND_SA,2021,86,TAMA,3879456,1788821,585720,983342,9404119,793860,1965285,9500,965155,8074869,28450127,3138965,0,31589092,0,2952841,34541933,POINT (-92.5325425 42.07981170000001)
2009_50_JASPER_EXPEND_SA,2009,50,JASPER,4808002,1963251,4851880,1310224,5709098,964513,2798328,11500,1826490,2049488,26292774,4362581,0,30655355,0,3819122,34474477,POINT (-93.053765 41.6860394)
2014_46_HUMBOLDT_EXPEND_SA,2014,46,HUMBOLDT,1784775,359009,1146517,749016,3263256,404812,1088608,0,0,245000,9040993,1635016,0,10676009,0,3965895,14641904,POINT (-94.2071868 42.7764686)
2008_86_TAMA_EXPEND_SA,2008,86,TAMA,2961542,1333427,1396312,663538,5811716,515208,1250436,11500,0,2234837,16178516,1537359,0,17715875,0,2505718,20221593,POINT (-92.5325425 42.07981170000001)
2005_55_KOSSUTH_EXPEND_SA,2005,55,KOSSUTH,2612375,407262,2176838,623442,5263000,573819,1531258,62036,1051952,1237500,15539482,2020896,,17560378,0,3369558,20929936,POINT (-94.2067199 43.20413)
2010_78_POTTAWATTAMIE_EXPEND_SA,2010,78,POTTAWATTAMIE,19345824,3134340,10183810,7420696,11337000,1968198,5575687,0,3896211,6700000,69561766,5924584,0,75486350,0,15905334,91391684,POINT (-95.5423935 41.3366123)
2022_25_DALLAS_EXPEND_SA,2022,25,DALLAS,15442262,2033935,3423303,3220958,9891985,2548624,2328009,104832,2314816,8430000,49738724,11422740,0,61161464,0,23486939,84648403,POINT (-94.0397374 41.6848862)
2008_17_CERRO GORDO_EXPEND_SA,2008,17,CERRO GORDO,6514171,5012588,5965000,1344484,4997890,968039,2358685,40500,1515659,4220000,32937016,2575675,0,35512691,0,8310458,43823149,POINT (-93.2608184 43.081557700000005)
2017_84_SIOUX_EXPEND_SA,2017,84,SIOUX,4810639,800164,932367,1581651,6658600,1005239,2508863,35000,873215,2906300,22112038,2981870,0,25093908,0,7167038,32260946,POINT (-96.1778827 43.0826174)
2018_85_STORY_EXPEND_SA,2018,85,STORY,11862605,2585205,1796570,4078611,6526900,1217068,5590037,0,1355532,3764680,38777208,3203561,0,41980769,0,17698537,59679306,POINT (-93.4650448 42.0362415)
2018_26_DAVIS_EXPEND_SA,2018,26,DAVIS,1617653,406015,327643,530764,4382200,418049,1083959,30493,411789,1150000,10358565,801300,0,11159865,0,1121885,12281750,POINT (-92.4097173 40.7476891)
2011_18_CHEROKEE_EXPEND_SA,2011,18,CHEROKEE,1753048,387260,1374878,694980,3904115,354088,1727728,0,0,1502000,11698097,1425000,0,13123097,0,2873682,15996779,POINT (-95.6238055 42.7356226)
2012_95_WINNEBAGO_EXPEND_SA,2012,95,WINNEBAGO,1534765,981205,1424842,897504,3258153,472004,1024786,5000,799798,5310247,15708304,1453223,0,17161527,0,3701224,20862751,POINT (-93.7341955 43.37756780000001)
2006_46_HUMBOLDT_EXPEND_SA,2006,46,HUMBOLDT,1313493,316758,1391204,499596,3085298,407335,1082168,0,0,240000,8335852,1075256,,9411108,0,2205152,11616260,POINT (-94.2071868 42.7764686)
2012_21_CLAY_EXPEND_SA,2012,21,CLAY,2381469,572940,1893511,1275219,4582266,430700,1606052,0,59925,1351000,14153082,2059698,0,16212780,0,4341978,20554758,POINT (-95.1509194 43.0825804)
2010_4_APPANOOSE_EXPEND_SA,2010,4,APPANOOSE,1851214,781025,1303253,767636,3163000,458996,901439,0,205440,300000,9732003,499940,0,10231943,0,5297687,15529630,POINT (-92.8686104 40.7431635)
2021_52_JOHNSON_EXPEND_SA,2021,52,JOHNSON,28642613,14258969,6401588,6447248,10775271,3348987,11207999,165700,20458257,23915801,125622433,18332635,0,143955068,0,25349359,169304427,POINT (-91.5880849 41.6715511)
2022_51_JEFFERSON_EXPEND_SA,2022,51,JEFFERSON,3811087,829903,823666,753494,4319000,638556,1728718,0,852405,3063506,16820335,1100000,0,17920335,0,3083458,21003793,POINT (-91.9488774 41.0317596)
2015_69_MONTGOMERY_EXPEND_SA,2015,69,MONTGOMERY,2247083,565261,1227743,390447,3823668,437562,1055294,200,409948,126462,10283668,780000,0,11063668,0,5125385,16189053,POINT (-95.1563758 41.03014)
2016_19_CHICKASAW_EXPEND_SA,2016,19,CHICKASAW,2176548,1694881,802355,781674,4936921,466823,1625058,4002,0,294985,12783247,1973629,0,14756876,0,4704611,19461487,POINT (-92.3176637 43.06004140000001)
2017_52_JOHNSON_EXPEND_SA,2017,52,JOHNSON,23615540,10256294,8489374,5000280,9567031,2777889,9080432,4500,17107388,16570205,102468933,17506460,0,119975393,0,22551339,142526732,POINT (-91.5880849 41.6715511)
2018_46_HUMBOLDT_EXPEND_SA,2018,46,HUMBOLDT,2088850,393794,829917,806297,3861123,495348,1257350,0,128787,559000,10420466,1853918,0,12274384,0,6405660,18680044,POINT (-94.2071868 42.7764686)
2005_50_JASPER_EXPEND_SA,2005,50,JASPER,3580536,1873118,3967657,939247,5006780,861583,2210858,500,790660,9480862,28711801,2214097,,30925898,0,3907569,34833467,POINT (-93.053765 41.6860394)
2009_71_O'BRIEN_EXPEND_SA,2009,71,O'BRIEN,2764155,548964,1877700,863162,3470850,493703,912718,10000,344897,779025,12065174,1273381,0,13338555,0,2005313,15343868,POINT (-95.6248784 43.0837527)
2016_4_APPANOOSE_EXPEND_SA,2016,4,APPANOOSE,2432259,965051,724802,839035,3797000,569483,1035494,0,152310,175000,10690434,771185,0,11461619,0,5212491,16674110,POINT (-92.8686104 40.7431635)
2008_39_GUTHRIE_EXPEND_SA,2008,39,GUTHRIE,1051250,1198909,1108700,1320757,3243446,381808,1098991,12500,450000,589000,10455361,1095079,0,11550440,0,4705840,16256280,POINT (-94.501055 41.6837548)
2022_83_SHELBY_EXPEND_SA,2022,83,SHELBY,2862472,623785,289450,521122,6341726,442355,1631052,12000,112000,947900,13783862,4000857,0,17784719,0,2847816,20632535,POINT (-95.31021130000002 41.6850926)
2016_2_ADAMS_EXPEND_SA,2016,2,ADAMS,1160003,251645,170644,767020,3111100,328263,751443,42500,803030,4255500,11641148,916246,0,12557394,0,1890143,14447537,POINT (-94.6991849 41.02898390000001)
2007_39_GUTHRIE_EXPEND_SA,2007,39,GUTHRIE,1012785,1153046,1078000,1060199,3672278,411325,1073988,0,450000,127000,10038621,888264,,10926885,0,4058371,14985256,POINT (-94.501055 41.6837548)
2014_29_DES MOINES_EXPEND_SA,2014,29,DES MOINES,6613175,1615592,2522762,2200703,4989429,1029391,3623603,0,755748,810000,24160403,3296167,0,27456570,0,5266138,32722708,POINT (-91.1814707 40.9231829)
2013_13_CALHOUN_EXPEND_SA,2013,13,CALHOUN,2064357,2233902,1489200,774479,4117786,568461,1161662,8675,0,726000,13144522,1291366,0,14435888,0,6257674,20693562,POINT (-94.6404136 42.385184800000005)
2006_83_SHELBY_EXPEND_SA,2006,83,SHELBY,1489634,375425,1825208,312496,4214516,362766,975950,25100,83674,940879,10605648,1012286,,11617934,0,2549056,14166990,POINT (-95.31021130000002 41.6850926)
2017_71_O'BRIEN_EXPEND_SA,2017,71,O'BRIEN,3365412,449711,826359,938708,4686000,595984,1553258,10100,284711,1174690,13884933,1943525,0,15828458,0,5996140,21824598,POINT (-95.6248784 43.0837527)
2012_12_BUTLER_EXPEND_SA,2012,12,BUTLER,2125630,1428248,28750000,792117,4850000,527815,1555288,10000,228010,3075000,43342108,3249000,0,46591108,0,4917710,51508818,POINT (-92.7901934 42.7315661)
2019_79_POWESHIEK_EXPEND_SA,2019,79,POWESHIEK,3209913,362113,435364,652042,7342947,663349,1332887,454900,748108,2989053,18190676,2785188,0,20975864,0,7412431,28388295,POINT (-92.53146840000001 41.6864422)
2014_57_LINN_EXPEND_SA,2014,57,LINN,24329540,15575915,21414579,6970137,12204452,4127626,13649631,0,1755463,8383082,108410425,16937491,0,125347916,0,23841219,149189135,POINT (-91.5989646 42.0789478)
2021_55_KOSSUTH_EXPEND_SA,2021,55,KOSSUTH,4076444,433066,562880,1246097,8735400,1134039,3011614,66636,0,3687500,22953676,2883537,0,25837213,0,6738212,32575425,POINT (-94.2067199 43.20413)
2017_37_GREENE_EXPEND_SA,2017,37,GREENE,1641545,453745,376603,844007,5483214,373852,1866518,260000,0,619000,11918484,1862000,0,13780484,0,3265484,17045968,POINT (-94.3968356 42.0362394)
2018_70_MUSCATINE_EXPEND_SA,2018,70,MUSCATINE,10178664,1182792,2245068,1364247,6449000,861645,3087850,0,2063436,3690000,31122702,2611560,0,33734262,0,10772246,44506508,POINT (-91.1127562 41.4839221)
2008_54_KEOKUK_EXPEND_SA,2008,54,KEOKUK,911117,771214,971729,484054,3726700,385997,1155284,0,0,624000,9030095,1004000,0,10034095,0,3409912,13444007,POINT (-92.1786426 41.336465)
2021_92_WASHINGTON_EXPEND_SA,2021,92,WASHINGTON,7744852,2401943,932530,1256851,7162528,884666,2590610,20000,3207693,3787018,29988691,3106594,0,33095285,0,4962994,38058279,POINT (-91.7178676 41.335591)
2010_46_HUMBOLDT_EXPEND_SA,2010,46,HUMBOLDT,1520298,384420,1345083,576902,3239355,397427,1082716,0,0,327000,8873201,1207397,0,10080598,0,3654635,13735233,POINT (-94.2071868 42.7764686)
2005_87_TAYLOR_EXPEND_SA,2005,87,TAYLOR,698985,861814,479031,160541,2446000,249400,557286,0,139141,4632401,10224599,482542,,10707141,0,538472,11245613,POINT (-94.6964148 40.73743240000001)
2006_61_MADISON_EXPEND_SA,2006,61,MADISON,1704367,507326,1051650,481915,3694330,432626,789532,0,152212,1219320,10033278,1135492,,11168770,0,1893080,13061850,POINT (-94.01556190000001 41.33071420000001)
2011_79_POWESHIEK_EXPEND_SA,2011,79,POWESHIEK,2638287,437586,1553069,1074017,5014650,718254,1152031,202493,607563,1111400,14509350,1980039,0,16489389,0,3883471,20372860,POINT (-92.53146840000001 41.6864422)
2012_72_OSCEOLA_EXPEND_SA,2012,72,OSCEOLA,1103670,234286,693158,431041,2675000,281905,689710,69781,439719,280000,6898270,1143359,0,8041629,0,2304090,10345719,POINT (-95.6236852 43.3785704)
2014_89_VAN BUREN_EXPEND_SA,2014,89,VAN BUREN,1147351,463809,222955,390160,3146000,304140,618251,5700,0,417600,6715966,666428,0,7382394,0,2114023,9496417,POINT (-91.9499871 40.7532294)
2011_11_BUENA VISTA_EXPEND_SA,2011,11,BUENA VISTA,2695749,1214399,1587334,698559,4258750,630209,1260196,25740,1052300,1409616,14832852,1860825,0,16693677,0,4354981,21048658,POINT (-95.15114900000002 42.7354936)
2017_7_BLACK HAWK_EXPEND_SA,2017,7,BLACK HAWK,21444509,7852219,6323340,6426151,7168298,2075678,6035764,0,9097091,9157000,75580050,3233429,0,78813479,0,26803976,105617455,POINT (-92.3088197 42.4700957)
2006_89_VAN BUREN_EXPEND_SA,2006,89,VAN BUREN,879059,359408,631996,356673,2615000,315179,486579,3500,0,367723,6015117,487301,,6502418,0,1424240,7926658,POINT (-91.9499871 40.7532294)
2017_22_CLAYTON_EXPEND_SA,2017,22,CLAYTON,2966489,636955,628037,1413493,6608416,703899,1761155,1500,337053,1756938,16813935,1700000,0,18513935,0,4908903,23422838,POINT (-91.34143280000002 42.8447493)
2014_10_BUCHANAN_EXPEND_SA,2014,10,BUCHANAN,3237849,596352,1230484,1087648,6334700,745019,1470135,59875,420218,1129000,16311280,2278477,0,18589757,0,3648759,22238516,POINT (-91.8378392 42.4707777)
2009_11_BUENA VISTA_EXPEND_SA,2009,11,BUENA VISTA,2473890,1216919,1678613,653739,4018035,605567,1241248,35285,1312087,1469350,14704733,1712257,0,16416990,0,3037246,19454236,POINT (-95.15114900000002 42.7354936)
2006_74_PALO ALTO_EXPEND_SA,2006,74,PALO ALTO,1209344,293418,1454337,953362,3265357,429384,1071414,0,113154,827146,9616916,1164312,,10781228,0,3734075,14515303,POINT (-94.6781371 43.0820643)
2013_40_HAMILTON_EXPEND_SA,2013,40,HAMILTON,2677155,1798542,2642270,1470140,4508500,494807,1303413,0,2484084,1075173,18454084,2532555,0,20986639,0,2307970,23294609,POINT (-93.7068085 42.3837722)
2006_15_CASS_EXPEND_SA,2006,15,CASS,1637291,476402,1905154,515359,3485740,504032,1014425,407900,0,1859436,11805739,1541890,,13347629,0,1072835,14420464,POINT (-94.9278266 41.3314876)
2011_88_UNION_EXPEND_SA,2011,88,UNION,1339070,429206,1562100,525058,4036610,449499,904150,0,1794159,2928437,13968289,639488,0,14607777,0,5662530,20270307,POINT (-94.2423792 41.0277304)
2019_23_CLINTON_EXPEND_SA,2019,23,CLINTON,8665689,2143610,1795148,1871362,6468512,1262265,4402055,0,2916522,20076144,49601307,3978209,0,53579516,0,2035626,55615142,POINT (-90.5319724 41.8980358)
2017_95_WINNEBAGO_EXPEND_SA,2017,95,WINNEBAGO,2079447,1474847,820659,992924,3652754,605228,1829360,10990,2818270,3839626,18124105,1577737,0,19701842,0,12376381,32078223,POINT (-93.7341955 43.37756780000001)
2007_22_CLAYTON_EXPEND_SA,2007,22,CLAYTON,2179122,474338,1904122,989572,5103450,503328,1462541,1300,262475,1090000,13970248,1200000,,15170248,0,5521370,20691618,POINT (-91.34143280000002 42.8447493)
2007_77_POLK_EXPEND_SA,2007,77,POLK,48625020,27646386,48601552,9944858,8824562,5918606,26998295,0,7242628,47385333,231187240,81700765,,312888005,0,65451723,378339728,POINT (-93.5735335 41.6855048)
2012_92_WASHINGTON_EXPEND_SA,2012,92,WASHINGTON,4393992,2504640,2303267,894396,4623092,688645,1857293,61200,2983795,8061268,28371588,2339428,0,30711016,0,3135423,33846439,POINT (-91.7178676 41.335591)
2016_29_DES MOINES_EXPEND_SA,2016,29,DES MOINES,6528171,1674256,2457789,1752801,5607416,1040591,3192421,0,2956152,1725535,26935132,2009135,0,28944267,0,7169679,36113946,POINT (-91.1814707 40.9231829)
2020_90_WAPELLO_EXPEND_SA,2020,90,WAPELLO,4697381,1211429,2034293,938840,5080631,766687,3189313,77283,487704,2003000,20486561,1200000,0,21686561,0,8380068,30066629,POINT (-92.4094499 41.03058450000001)
2015_22_CLAYTON_EXPEND_SA,2015,22,CLAYTON,2896906,766837,859471,1175262,7242980,685830,1789629,1300,329371,1084274,16831860,1600000,0,18431860,0,4887950,23319810,POINT (-91.34143280000002 42.8447493)
2009_24_CRAWFORD_EXPEND_SA,2009,24,CRAWFORD,1515768,2531103,2423040,834443,4694100,507717,1376878,0,243365,1927000,16053414,1470000,0,17523414,0,4747343,22270757,POINT (-95.3819678 42.0372125)
2005_82_SCOTT_EXPEND_SA,2005,82,SCOTT,15960225,5744453,13160374,3746490,3916900,1801748,7171510,0,1046926,5666508,58215134,6169651,,64384785,0,15919714,80304499,POINT (-90.6232428 41.6370978)
2020_40_HAMILTON_EXPEND_SA,2020,40,HAMILTON,3704669,1777470,1544815,2483720,7979950,623939,1883509,0,3599077,1181090,24778239,4434451,0,29212690,0,3057565,32270255,POINT (-93.7068085 42.3837722)
2015_59_LUCAS_EXPEND_SA,2015,59,LUCAS,1116677,766460,426538,381209,3320976,305060,920375,0,284279,320200,7841774,604252,0,8446026,0,1190506,9636532,POINT (-93.3277207 41.0293738)
2012_44_HENRY_EXPEND_SA,2012,44,HENRY,3142997,883245,3208819,911150,3357200,649149,1170802,43500,150000,716000,14232862,1081504,0,15314366,0,2497044,17811410,POINT (-91.5445241 40.9879383)
2018_63_MARION_EXPEND_SA,2018,63,MARION,4899090,3022994,1195732,2122400,8268810,1027629,3085410,0,465215,1963310,26050590,2402340,0,28452930,0,9143304,37596234,POINT (-93.0994367 41.3344515)
2008_81_SAC_EXPEND_SA,2008,81,SAC,1830655,572692,1800337,739689,3491000,341787,1035676,0,55000,613000,10479836,879539,0,11359375,0,1690674,13050049,POINT (-95.1053946 42.3862604)
2021_6_BENTON_EXPEND_SA,2021,6,BENTON,5128084,1468123,1359223,5350663,8876835,988325,2347690,108000,0,2558500,28185443,4495000,0,32680443,0,5636790,38317233,POINT (-92.0656912 42.0801864)
2015_1_ADAIR_EXPEND_SA,2015,1,ADAIR,1418180,350961,306568,525496,4620827,352894,830957,0,1203044,5110780,14719707,5331913,0,20051620,0,4844289,24895909,POINT (-94.4709413 41.3307464)
2015_7_BLACK HAWK_EXPEND_SA,2015,7,BLACK HAWK,19054037,7832261,6800872,3796775,5837756,1809293,5735454,0,6751628,908652,58526728,2931802,0,61458530,0,21092379,82550909,POINT (-92.3088197 42.4700957)
2020_8_BOONE_EXPEND_SA,2020,8,BOONE,4247636,734206,758300,1312052,7108419,721260,2095733,200000,710831,1306000,19194437,3593111,0,22787548,0,4138700,26926248,POINT (-93.931671 42.0365493)
2021_20_CLARKE_EXPEND_SA,2021,20,CLARKE,2421960,963427,381431,398763,4440500,630716,1431503,0,86165,285000,11039465,908048,0,11947513,0,2252895,14200408,POINT (-93.78515790000002 41.0290323)
2007_33_FAYETTE_EXPEND_SA,2007,33,FAYETTE,2512321,551667,2479764,1214269,4569264,520585,1070974,6750,350760,1144040,14420394,1431195,,15851589,0,1241890,17093479,POINT (-91.8443207 42.8625919)
2020_58_LOUISA_EXPEND_SA,2020,58,LOUISA,3310198,853190,384570,1086837,4171758,408986,1307430,0,344910,1017451,12885330,1597430,0,14482760,0,2397596,16880356,POINT (-91.2596184 41.2185073)
2008_66_MITCHELL_EXPEND_SA,2008,66,MITCHELL,1401281,908370,1514994,1079781,3200000,249310,885368,500,340418,415000,9995022,1121050,0,11116072,0,1997874,13113946,POINT (-92.7890315 43.3564124)
2009_56_LEE_EXPEND_SA,2009,56,LEE,3753859,3801608,4713218,1347498,3760879,967570,2412828,275000,759918,4507000,26299378,1089400,0,27388778,0,7926748,35315526,POINT (-91.479264 40.6419764)
2005_77_POLK_EXPEND_SA,2005,77,POLK,40203852,25478422,41669661,12791359,8479069,5121552,20311118,50000,5457149,7206499,166768681,11772137,,178540818,0,42757008,221297826,POINT (-93.5735335 41.6855048)
2010_73_PAGE_EXPEND_SA,2010,73,PAGE,1622453,727124,1893204,319749,3761000,435803,956066,5000,105595,509251,10335245,719376,0,11054621,0,2461684,13516305,POINT (-95.1501747 40.7391444)
2005_8_BOONE_EXPEND_SA,2005,8,BOONE,2354823,785346,2003100,809018,4336100,528846,1307947,0,433495,1356400,13915075,200560,,14115635,0,3978713,18094348,POINT (-93.931671 42.0365493)
2022_40_HAMILTON_EXPEND_SA,2022,40,HAMILTON,3950951,1901442,464901,2284036,6088000,608702,2085433,0,2572032,1288895,21244392,3704801,0,24949193,0,3673422,28622615,POINT (-93.7068085 42.3837722)
2016_56_LEE_EXPEND_SA,2016,56,LEE,4850162,4907202,2526322,1459093,5088800,1117112,2138715,56740,954977,7734459,30833582,1676614,0,32510196,0,7794629,40304825,POINT (-91.479264 40.6419764)
2007_48_IOWA_EXPEND_SA,2007,48,IOWA,2198267,792003,1311790,771086,4386076,424513,1334580,21780,432903,1035000,12707998,960000,,13667998,0,3476301,17144299,POINT (-92.065524 41.6863229)
2022_89_VAN BUREN_EXPEND_SA,2022,89,VAN BUREN,1508242,612165,300074,453992,4240000,341275,701912,40600,0,725000,8923260,1049517,0,9972777,0,4364173,14336950,POINT (-91.9499871 40.7532294)
2012_45_HOWARD_EXPEND_SA,2012,45,HOWARD,1390817,500510,1225800,1516418,3518118,395252,1029040,1000,224411,21901,9823267,970770,0,10794037,0,2566256,13360293,POINT (-92.3171989 43.3567673)
2008_22_CLAYTON_EXPEND_SA,2008,22,CLAYTON,2253600,546365,2058704,1047104,5091744,552973,1456499,1300,378475,1433000,14819764,1300000,0,16119764,0,5783795,21903559,POINT (-91.34143280000002 42.8447493)
2010_15_CASS_EXPEND_SA,2010,15,CASS,2208436,471191,2666700,525392,4399000,426377,1102364,1068012,53125,1901238,14821835,1688771,0,16510606,0,750402,17261008,POINT (-94.9278266 41.3314876)
2013_89_VAN BUREN_EXPEND_SA,2013,89,VAN BUREN,1131583,596508,669395,384138,3245000,310997,607690,5700,0,167600,7118611,635140,0,7753751,0,2292370,10046121,POINT (-91.9499871 40.7532294)
2005_40_HAMILTON_EXPEND_SA,2005,40,HAMILTON,1903983,2370557,2009452,1118064,3367100,403127,1108869,0,1029056,1351900,14662108,2564286,,17226394,0,3330246,20556640,POINT (-93.7068085 42.3837722)
2011_56_LEE_EXPEND_SA,2011,56,LEE,4387492,3828187,5004578,1275447,4168700,983777,2292845,0,813452,839363,23593841,1250000,0,24843841,0,6017621,30861462,POINT (-91.479264 40.6419764)
2015_54_KEOKUK_EXPEND_SA,2015,54,KEOKUK,1154634,732907,490075,357274,4282050,375763,2177463,0,0,354000,9924166,1321200,0,11245366,0,3334918,14580284,POINT (-92.1786426 41.336465)
2009_39_GUTHRIE_EXPEND_SA,2009,39,GUTHRIE,1112175,1228120,1484071,1386764,4405710,398634,1110342,0,400000,1189000,12714816,1183668,0,13898484,0,2827351,16725835,POINT (-94.501055 41.6837548)
2005_99_WRIGHT_EXPEND_SA,2005,99,WRIGHT,1440207,2669859,1436851,935281,3750000,556548,999619,28370,168678,880000,12865413,1105113,,13970526,0,3083159,17053685,POINT (-93.7351465 42.7331189)
2011_23_CLINTON_EXPEND_SA,2011,23,CLINTON,7502381,1683021,8710755,1715542,5235587,1360669,3417854,40000,1364713,15300695,46331217,975000,0,47306217,0,5674991,52981208,POINT (-90.5319724 41.8980358)
2008_7_BLACK HAWK_EXPEND_SA,2008,7,BLACK HAWK,15683002,11522030,21795291,2866054,5069991,1754774,5065274,0,2742504,1953277,68452197,1860555,0,70312752,0,7510060,77822812,POINT (-92.3088197 42.4700957)
2016_34_FLOYD_EXPEND_SA,2016,34,FLOYD,2754314,1375528,1293415,985214,5290850,680437,1274226,0,695678,725000,15074662,1256895,0,16331557,0,5443179,21774736,POINT (-92.78900330000002 43.0599208)
2007_74_PALO ALTO_EXPEND_SA,2007,74,PALO ALTO,1289135,351512,1454337,1014895,3319419,354533,1074354,0,407480,468250,9733915,1385764,,11119679,0,3686934,14806613,POINT (-94.6781371 43.0820643)
2022_8_BOONE_EXPEND_SA,2022,8,BOONE,4600965,737908,493369,2357148,8103200,834581,2254360,100000,710627,1950000,22142158,3984881,0,26127039,0,2297463,28424502,POINT (-93.931671 42.0365493)
2007_11_BUENA VISTA_EXPEND_SA,2007,11,BUENA VISTA,2201361,1143823,1507125,712458,3703765,519127,1130285,34800,1543036,5721050,18216830,1636600,,19853430,0,3393742,23247172,POINT (-95.15114900000002 42.7354936)
2020_87_TAYLOR_EXPEND_SA,2020,87,TAYLOR,1768500,1398983,169000,483287,4129550,383822,948314,0,988655,302500,10572611,943568,0,11516179,0,2921794,14437973,POINT (-94.6964148 40.73743240000001)
2011_6_BENTON_EXPEND_SA,2011,6,BENTON,3422547,930247,2118376,1581186,6293500,581860,1403897,0,578000,9945338,26854951,2728352,0,29583303,0,5324617,34907920,POINT (-92.0656912 42.0801864)
2018_90_WAPELLO_EXPEND_SA,2018,90,WAPELLO,4435533,1338136,1660842,913796,4728760,766258,3160483,80237,780056,3273000,21137101,1150000,0,22287101,0,10480522,32767623,POINT (-92.4094499 41.03058450000001)
2019_54_KEOKUK_EXPEND_SA,2019,54,KEOKUK,1272793,751793,340159,477568,6594900,430270,2163713,0,0,2335000,14366196,2192000,0,16558196,0,3440448,19998644,POINT (-92.1786426 41.336465)
2018_21_CLAY_EXPEND_SA,2018,21,CLAY,2987497,772062,403438,1458042,5181292,551008,2081597,0,485358,1058964,14979258,2169279,0,17148537,0,7494644,24643181,POINT (-95.1509194 43.0825804)
2013_72_OSCEOLA_EXPEND_SA,2013,72,OSCEOLA,1187143,237450,693480,559434,2715000,284988,703952,65530,438185,285000,7170162,1227955,0,8398117,0,2354573,10752690,POINT (-95.6236852 43.3785704)
2016_87_TAYLOR_EXPEND_SA,2016,87,TAYLOR,1654827,1162310,152707,310724,3425000,362343,730823,0,1034360,2242206,11075300,797881,0,11873181,0,2309624,14182805,POINT (-94.6964148 40.73743240000001)
2013_99_WRIGHT_EXPEND_SA,2013,99,WRIGHT,1982653,3816747,1566152,1003118,4539000,565164,1267700,28075,338540,1469000,16576149,1701776,0,18277925,0,3490786,21768711,POINT (-93.7351465 42.7331189)
2021_84_SIOUX_EXPEND_SA,2021,84,SIOUX,4990235,911870,1039782,1924611,7982210,1109432,2675078,42600,1128942,6785082,28589842,4325208,0,32915050,0,14128217,47043267,POINT (-96.1778827 43.0826174)
2009_82_SCOTT_EXPEND_SA,2009,82,SCOTT,20219107,6207864,16184078,4316421,4632500,1964811,8953706,0,3463137,6910523,72852147,9700891,0,82553038,0,13916150,96469188,POINT (-90.6232428 41.6370978)
2013_20_CLARKE_EXPEND_SA,2013,20,CLARKE,1646353,966034,1011271,260187,2530900,398547,936010,0,397060,545014,8691376,617631,0,9309007,0,2649596,11958603,POINT (-93.78515790000002 41.0290323)
2008_91_WARREN_EXPEND_SA,2008,91,WARREN,4111088,2625468,3441547,944664,5899060,680118,2371694,0,556953,1494028,22124620,2038444,0,24163064,0,3851053,28014117,POINT (-93.5613594 41.3343735)
2019_86_TAMA_EXPEND_SA,2019,86,TAMA,3850773,1684795,974856,922022,8952296,589587,1760958,39500,569835,3140691,22485313,2738291,0,25223604,0,7989810,33213414,POINT (-92.5325425 42.07981170000001)
2009_99_WRIGHT_EXPEND_SA,2009,99,WRIGHT,1777322,3351937,1751043,1035828,3635000,480064,1086872,49720,308208,840000,14315994,1313920,0,15629914,0,2479855,18109769,POINT (-93.7351465 42.7331189)
2015_91_WARREN_EXPEND_SA,2015,91,WARREN,4628616,4084966,2217006,1264963,6346210,930063,2942540,0,53906,1122394,23590664,3005000,0,26595664,0,6631025,33226689,POINT (-93.5613594 41.3343735)
2011_38_GRUNDY_EXPEND_SA,2011,38,GRUNDY,1697732,468329,1288551,938447,3961635,386046,1596611,0,1284168,2303000,13924519,1576250,0,15500769,0,4151143,19651912,POINT (-92.7914177 42.4018651)
2012_66_MITCHELL_EXPEND_SA,2012,66,MITCHELL,1389105,1768034,615000,1879936,3607000,301487,1025345,0,863034,3392534,14841475,5178267,0,20019742,0,2683837,22703579,POINT (-92.7890315 43.3564124)
2018_53_JONES_EXPEND_SA,2018,53,JONES,2774543,744003,1296476,2305328,6881932,719138,1835677,92652,390479,2980383,20020611,2320861,0,22341472,0,7459499,29800971,POINT (-91.1314352 42.1212397)
2008_49_JACKSON_EXPEND_SA,2008,49,JACKSON,1516268,471744,2283241,1032670,3762211,507037,1487310,133640,0,1318540,12512661,1366500,0,13879161,0,4110478,17989639,POINT (-90.5742294 42.1717426)
2013_67_MONONA_EXPEND_SA,2013,67,MONONA,1717742,562377,971380,677911,5493893,440188,1473639,0,48400,574662,11960192,1293169,0,13253361,0,4017901,17271262,POINT (-95.9599235 42.0516663)
2008_71_O'BRIEN_EXPEND_SA,2008,71,O'BRIEN,2682772,474299,1688500,800428,3563200,469480,854806,10500,416797,1734000,12694782,1549272,0,14244054,0,2206539,16450593,POINT (-95.6248784 43.0837527)
2020_73_PAGE_EXPEND_SA,2020,73,PAGE,2976868,584259,425708,505812,4773500,652777,1625279,8000,428391,2600000,14580594,1475991,0,16056585,0,6021132,22077717,POINT (-95.1501747 40.7391444)
2010_58_LOUISA_EXPEND_SA,2010,58,LOUISA,2175584,619445,1324500,628356,2995410,278630,1049563,0,356298,1359450,10787236,2208059,0,12995295,0,4031861,17027156,POINT (-91.2596184 41.2185073)
2010_41_HANCOCK_EXPEND_SA,2010,41,HANCOCK,1383598,2252090,1650000,556266,4712300,359100,1045237,5750,0,915000,12879341,1775210,0,14654551,0,4852439,19506990,POINT (-93.7342723 43.0818861)
2013_25_DALLAS_EXPEND_SA,2013,25,DALLAS,8112572,2871143,4118726,2853297,7404697,1944095,1805090,58000,1755674,5132731,36056025,3808462,0,39864487,0,16527291,56391778,POINT (-94.0397374 41.6848862)
2006_5_AUDUBON_EXPEND_SA,2006,5,AUDUBON,919903,548194,777000,495423,2926765,305127,622803,1235,408053,957000,7961503,583683,,8545186,0,2735966,11281152,POINT (-94.9058222 41.6845893)
2011_16_CEDAR_EXPEND_SA,2011,16,CEDAR,3046898,1398426,2662423,3220775,4881440,533675,1493862,4770,0,1352000,18594269,1887629,0,20481898,0,3038191,23520089,POINT (-91.1324125 41.7723207)
2008_27_DECATUR_EXPEND_SA,2008,27,DECATUR,897277,1077137,991437,317934,2513732,257966,601086,0,75000,250510,6982079,529885,0,7511964,0,1531174,9043138,POINT (-93.7862815 40.7376827)
2021_47_IDA_EXPEND_SA,2021,47,IDA,1059837,296206,246276,891516,4205240,331571,947676,0,543835,3900000,12422157,1684723,0,14106880,0,2996721,17103601,POINT (-95.5134962 42.3868747)
2022_49_JACKSON_EXPEND_SA,2022,49,JACKSON,2794040,454918,532635,2010649,6303447,719017,2626291,0,367042,2043318,17851357,1585169,0,19436526,0,5974370,25410896,POINT (-90.5742294 42.1717426)
2011_1_ADAIR_EXPEND_SA,2011,1,ADAIR,1009378,272700,969906,402577,4033430,278745,746196,0,0,1607000,9319932,1342019,0,10661951,0,2482703,13144654,POINT (-94.4709413 41.3307464)
2006_42_HARDIN_EXPEND_SA,2006,42,HARDIN,2760978,328549,1739815,854774,3913615,342995,1168999,61630,521589,922000,12614944,2415975,,15030919,0,4505396,19536315,POINT (-93.2404025 42.3838803)
2013_8_BOONE_EXPEND_SA,2013,8,BOONE,3332582,788333,2731750,2186011,5430000,606519,1910329,0,759480,1921200,19666204,2257217,0,21923421,0,3117463,25040884,POINT (-93.931671 42.0365493)
2007_16_CEDAR_EXPEND_SA,2007,16,CEDAR,2541120,1246224,2471284,1011051,4495952,459564,1348906,0,517725,1315000,15406826,2146461,,17553287,0,3938574,21491861,POINT (-91.1324125 41.7723207)
2016_74_PALO ALTO_EXPEND_SA,2016,74,PALO ALTO,1853462,433961,448101,1525826,4915332,443072,1248706,0,1761971,4941776,17572207,2266165,0,19838372,0,10802518,30640890,POINT (-94.6781371 43.0820643)
2012_34_FLOYD_EXPEND_SA,2012,34,FLOYD,2322957,1758591,858758,681466,4878694,599821,1449895,0,558616,4690000,17798798,1340904,0,19139702,0,5220645,24360347,POINT (-92.78900330000002 43.0599208)
2011_28_DELAWARE_EXPEND_SA,2011,28,DELAWARE,2053765,709750,2599522,816462,4222625,616084,1281100,24900,73000,1806000,14203208,1813253,0,16016461,0,2876972,18893433,POINT (-91.3673502 42.471211)
2005_92_WASHINGTON_EXPEND_SA,2005,92,WASHINGTON,2811662,2162754,1699500,507670,4120000,552268,1407910,66875,68325,3385500,16782464,1475200,,18257664,0,2376800,20634464,POINT (-91.7178676 41.335591)
2009_88_UNION_EXPEND_SA,2009,88,UNION,1232155,516673,1459389,446032,2677622,424991,804497,0,808442,276270,8646071,578940,0,9225011,0,2068589,11293600,POINT (-94.2423792 41.0277304)
2013_57_LINN_EXPEND_SA,2013,57,LINN,23347276,14618793,35243322,6974797,12036547,3933558,12994391,0,1763423,8298643,119210750,15610674,0,134821424,0,19950842,154772266,POINT (-91.5989646 42.0789478)
2012_8_BOONE_EXPEND_SA,2012,8,BOONE,3251700,765416,2721079,3751902,5634500,627556,1817054,0,643530,1210000,20422737,2164113,0,22586850,0,2140879,24727729,POINT (-93.931671 42.0365493)
2010_26_DAVIS_EXPEND_SA,2010,26,DAVIS,1052547,312417,669119,312977,2766530,360852,844935,20000,0,140750,6480127,625566,0,7105693,0,3490074,10595767,POINT (-92.4097173 40.7476891)
2005_67_MONONA_EXPEND_SA,2005,67,MONONA,1320873,697800,752353,493343,3989253,514120,1298456,0,0,1456000,10522198,905000,,11427198,0,3636743,15063941,POINT (-95.9599235 42.0516663)
2007_43_HARRISON_EXPEND_SA,2007,43,HARRISON,2141515,1466418,1456721,779778,4548000,467627,1113553,0,559264,861650,13394526,1213682,,14608208,0,6415829,21024037,POINT (-95.8169209 41.6828528)
2007_54_KEOKUK_EXPEND_SA,2007,54,KEOKUK,898990,697666,834865,465506,3737400,366525,1091265,0,3547,309000,8404764,1004000,,9408764,0,2804610,12213374,POINT (-92.1786426 41.336465)
2018_39_GUTHRIE_EXPEND_SA,2018,39,GUTHRIE,1855456,1501900,260371,1309472,5647286,424602,1180062,15000,490453,3335000,16019602,1749361,0,17768963,0,5818133,23587096,POINT (-94.501055 41.6837548)
2015_40_HAMILTON_EXPEND_SA,2015,40,HAMILTON,2950324,1702630,1579976,1498390,4451100,551233,1343825,0,2828202,914154,17819834,3003267,0,20823101,0,17169278,37992379,POINT (-93.7068085 42.3837722)
2014_5_AUDUBON_EXPEND_SA,2014,5,AUDUBON,1151125,583998,263257,504560,3335002,308878,683922,100,79209,122789,7032840,666222,0,7699062,0,1966462,9665524,POINT (-94.9058222 41.6845893)
2016_61_MADISON_EXPEND_SA,2016,61,MADISON,2684457,954344,512565,794646,4592873,515883,1013812,0,94055,2254297,13416932,1609690,0,15026622,0,3821878,18848500,POINT (-94.01556190000001 41.33071420000001)
2014_74_PALO ALTO_EXPEND_SA,2014,74,PALO ALTO,1817065,411907,706134,1654897,4932170,443710,1186563,0,1340374,1227943,13720763,1351298,0,15072061,0,3405408,18477469,POINT (-94.6781371 43.0820643)
2011_33_FAYETTE_EXPEND_SA,2011,33,FAYETTE,2953608,534563,3170350,1436877,5079200,656710,1206565,27700,358500,933100,16357173,1702282,0,18059455,0,1720325,19779780,POINT (-91.8443207 42.8625919)
2014_25_DALLAS_EXPEND_SA,2014,25,DALLAS,8423958,3016211,4378675,3114647,7378215,2225181,1820633,58000,1816375,7145472,39377367,4291077,0,43668444,0,13412612,57081056,POINT (-94.0397374 41.6848862)
2018_58_LOUISA_EXPEND_SA,2018,58,LOUISA,3093285,913742,392034,788177,3772797,387933,1277390,0,339750,561166,11526274,1882500,0,13408774,0,5272170,18680944,POINT (-91.2596184 41.2185073)
2020_72_OSCEOLA_EXPEND_SA,2020,72,OSCEOLA,1770750,251109,90960,1655784,5141032,322053,1321208,157814,1323525,61000,12095235,1379106,0,13474341,0,4254572,17728913,POINT (-95.6236852 43.3785704)
2012_77_POLK_EXPEND_SA,2012,77,POLK,64383438,39264114,51559012,14006066,10675976,7562923,31061816,100000,13204943,10771022,242589310,19196607,0,261785917,0,55886945,317672862,POINT (-93.5735335 41.6855048)
2019_75_PLYMOUTH_EXPEND_SA,2019,75,PLYMOUTH,4428209,398675,582851,1208121,8880000,946438,2894658,0,1084145,6369970,26793067,4262300,0,31055367,0,5200000,36255367,POINT (-96.2140431 42.7378346)
2014_53_JONES_EXPEND_SA,2014,53,JONES,2411027,787388,1203067,833995,6440029,635523,1544279,586507,500,573590,15015905,1790000,0,16805905,0,3083868,19889773,POINT (-91.1314352 42.1212397)
2015_33_FAYETTE_EXPEND_SA,2015,33,FAYETTE,3705224,546978,1304584,1572064,5407350,768808,1449030,137400,0,537850,15429288,1835308,0,17264596,0,3288744,20553340,POINT (-91.8443207 42.8625919)
2018_7_BLACK HAWK_EXPEND_SA,2018,7,BLACK HAWK,22452143,8084166,6630230,3583936,7972485,2193423,6210078,0,8492247,3533930,69152638,8746584,0,77899222,0,26331022,104230244,POINT (-92.3088197 42.4700957)
2011_75_PLYMOUTH_EXPEND_SA,2011,75,PLYMOUTH,2961760,380254,1789986,938065,6315000,724616,3572643,0,1268700,893780,18844804,3047000,0,21891804,0,2068401,23960205,POINT (-96.2140431 42.7378346)
2006_57_LINN_EXPEND_SA,2006,57,LINN,19292790,13943004,25996487,5280861,10430917,3261042,8970064,17854,1253398,1600000,90046417,4955514,,95001931,0,19227914,114229845,POINT (-91.5989646 42.0789478)
2007_1_ADAIR_EXPEND_SA,2007,1,ADAIR,846741,244133,704805,297121,3504107,217785,558448,0,189330,413000,6975470,1019381,,7994851,0,2748763,10743614,POINT (-94.4709413 41.3307464)
2016_89_VAN BUREN_EXPEND_SA,2016,89,VAN BUREN,1213342,474646,155830,352344,2975000,265299,671471,5700,0,765000,6878632,664126,0,7542758,0,2634418,10177176,POINT (-91.9499871 40.7532294)
2018_95_WINNEBAGO_EXPEND_SA,2018,95,WINNEBAGO,2237078,1566883,797870,1044538,3853403,606633,1449748,9990,2898740,1173167,15638050,1730265,0,17368315,0,22079808,39448123,POINT (-93.7341955 43.37756780000001)
2006_10_BUCHANAN_EXPEND_SA,2006,10,BUCHANAN,2691515,253120,2410226,824321,4420000,655908,1849097,32556,190679,911500,14238922,1647977,,15886899,0,1895736,17782635,POINT (-91.8378392 42.4707777)
2008_34_FLOYD_EXPEND_SA,2008,34,FLOYD,2036687,1315549,2041050,752319,4257450,553580,1136418,0,179539,3803000,16075592,857159,0,16932751,0,3865367,20798118,POINT (-92.78900330000002 43.0599208)
2009_67_MONONA_EXPEND_SA,2009,67,MONONA,1579790,731213,911760,638549,3707601,412633,1420089,0,51605,782105,10235345,998636,0,11233981,0,2949475,14183456,POINT (-95.9599235 42.0516663)
2014_42_HARDIN_EXPEND_SA,2014,42,HARDIN,3834355,222597,904944,927360,5220705,542181,1728026,104682,1053641,597300,15135791,2395596,0,17531387,0,7037774,24569161,POINT (-93.2404025 42.3838803)
2015_72_OSCEOLA_EXPEND_SA,2015,72,OSCEOLA,1247337,225732,230225,550351,3077286,319618,823602,61027,468662,220000,7223840,922140,0,8145980,0,3085832,11231812,POINT (-95.6236852 43.3785704)
2016_24_CRAWFORD_EXPEND_SA,2016,24,CRAWFORD,2172343,3005486,688661,1185817,7329625,654283,1376007,0,154550,980075,17546847,2690500,0,20237347,0,6888988,27126335,POINT (-95.3819678 42.0372125)
2022_6_BENTON_EXPEND_SA,2022,6,BENTON,5728556,1369234,1181583,3567308,9257361,991548,2685266,151200,0,2127000,27059056,4456750,0,31515806,0,7071929,38587735,POINT (-92.0656912 42.0801864)
2014_22_CLAYTON_EXPEND_SA,2014,22,CLAYTON,2677266,760600,859970,1383751,7481854,696005,1482574,1300,324539,2237367,17905226,1600000,0,19505226,0,4792276,24297502,POINT (-91.34143280000002 42.8447493)
2011_92_WASHINGTON_EXPEND_SA,2011,92,WASHINGTON,4408284,2468492,2288420,899427,4652175,658612,1839159,55800,2372735,1315000,20958104,1829977,0,22788081,0,3599760,26387841,POINT (-91.7178676 41.335591)
2010_27_DECATUR_EXPEND_SA,2010,27,DECATUR,932274,1196641,1225456,315100,2855815,274978,644374,0,0,196000,7640638,621454,0,8262092,0,1339581,9601673,POINT (-93.7862815 40.7376827)
2016_83_SHELBY_EXPEND_SA,2016,83,SHELBY,2306425,540978,805227,411224,5052995,492484,1213812,10000,0,889000,11722145,2857693,0,14579838,0,2557225,17137063,POINT (-95.31021130000002 41.6850926)
2014_93_WAYNE_EXPEND_SA,2014,93,WAYNE,1376395,1021523,480706,231587,3496556,238982,879631,33200,401330,130000,8289910,548000,0,8837910,0,3028343,11866253,POINT (-93.3273639 40.73947020000001)
2017_11_BUENA VISTA_EXPEND_SA,2017,11,BUENA VISTA,4307268,1421482,892061,875761,5625000,846840,1951611,5000,960473,1407724,18293220,2475326,0,20768546,0,6931182,27699728,POINT (-95.15114900000002 42.7354936)
2006_32_EMMET_EXPEND_SA,2006,32,EMMET,1171522,576196,1643213,353516,2573801,429831,875620,0,18095,299492,7941286,547734,,8489020,0,1000366,9489386,POINT (-94.6784803 43.37802250000001)
2019_11_BUENA VISTA_EXPEND_SA,2019,11,BUENA VISTA,4588174,1577871,680996,1546294,6175000,884470,1932399,110100,860248,2377700,20733252,2570175,0,23303427,0,4834507,28137934,POINT (-95.15114900000002 42.7354936)
2009_4_APPANOOSE_EXPEND_SA,2009,4,APPANOOSE,2297890,788670,1271393,455096,3167000,520366,790415,0,974440,1243000,11508270,499940,0,12008210,0,3909387,15917597,POINT (-92.8686104 40.7431635)
2019_89_VAN BUREN_EXPEND_SA,2019,89,VAN BUREN,1361596,520048,223435,414464,4710000,289261,693638,5600,0,315000,8533042,840146,0,9373188,0,2564997,11938185,POINT (-91.9499871 40.7532294)
2021_11_BUENA VISTA_EXPEND_SA,2021,11,BUENA VISTA,5028907,1686281,923038,2470379,6600000,935665,2360132,322496,1309493,1579655,23216046,2748709,0,25964755,0,5177900,31142655,POINT (-95.15114900000002 42.7354936)
2022_17_CERRO GORDO_EXPEND_SA,2022,17,CERRO GORDO,10179049,6318711,1871015,2089741,8477131,1364238,3978574,0,952788,3750000,38981247,9740523,0,48721770,0,16773369,65495139,POINT (-93.2608184 43.081557700000005)
2014_69_MONTGOMERY_EXPEND_SA,2014,69,MONTGOMERY,2121632,531658,443622,371292,3461856,427913,990788,200,408237,329534,9086732,1138239,0,10224971,0,4579127,14804098,POINT (-95.1563758 41.03014)
2017_26_DAVIS_EXPEND_SA,2017,26,DAVIS,1282004,403688,247964,1212928,4381739,389214,920789,30493,410691,1000000,10279510,775594,0,11055104,0,1510787,12565891,POINT (-92.4097173 40.7476891)
2012_76_POCAHONTAS_EXPEND_SA,2012,76,POCAHONTAS,1667395,1609217,1012686,990473,4245161,350435,1406380,12385,0,1042000,12336132,1200000,0,13536132,0,748657,14284789,POINT (-94.67874660000001 42.73413510000001)
2013_36_FREMONT_EXPEND_SA,2013,36,FREMONT,1735958,315010,1391499,766055,3802000,404009,1285816,2300,142348,303000,10147995,1042318,0,11190313,0,3766817,14957130,POINT (-95.6046765 40.7455892)
2011_43_HARRISON_EXPEND_SA,2011,43,HARRISON,1943757,1555962,2097022,874148,5395000,464715,1833596,0,456886,720600,15341686,1482497,0,16824183,0,4528697,21352880,POINT (-95.8169209 41.6828528)
2015_55_KOSSUTH_EXPEND_SA,2015,55,KOSSUTH,2962714,360109,1174932,1031282,6972000,807892,1983614,82676,0,2075000,17450219,2807151,0,20257370,0,6233788,26491158,POINT (-94.2067199 43.20413)
2012_3_ALLAMAKEE_EXPEND_SA,2012,3,ALLAMAKEE,1527303,677540,2188925,1402430,5166110,437357,892089,49350,0,3309100,15650204,1469316,0,17119520,0,1795520,18915040,POINT (-91.3780923 43.2842838)
2017_58_LOUISA_EXPEND_SA,2017,58,LOUISA,3045479,896938,390635,676323,3455043,386212,1173165,0,344630,737100,11105525,1777380,0,12882905,0,4112651,16995556,POINT (-91.2596184 41.2185073)
2015_77_POLK_EXPEND_SA,2015,77,POLK,68848543,35295049,27291859,12061271,10105638,7221561,30745631,0,20187266,27607317,239364135,11965158,0,251329293,0,64068743,315398036,POINT (-93.5735335 41.6855048)
2007_81_SAC_EXPEND_SA,2007,81,SAC,1716319,559609,1242870,585752,3519260,315291,970825,0,51800,506000,9467726,851992,,10319718,0,2099100,12418818,POINT (-95.1053946 42.3862604)
2019_60_LYON_EXPEND_SA,2019,60,LYON,3369325,656846,117540,910444,6547700,468444,1197006,110409,597500,2866355,16841569,2797916,0,19639485,0,6936243,26575728,POINT (-96.2102924 43.380497)
2020_44_HENRY_EXPEND_SA,2020,44,HENRY,4366538,1593769,1001940,1164775,5559517,787191,1498248,68300,866850,1596700,18503828,1747202,0,20251030,0,1432769,21683799,POINT (-91.5445241 40.9879383)
2013_77_POLK_EXPEND_SA,2013,77,POLK,64986638,35255104,57518768,11513460,9477092,7231852,31107645,0,12847972,11325876,241264407,15048355,0,256312762,0,61083700,317396462,POINT (-93.5735335 41.6855048)
2012_88_UNION_EXPEND_SA,2012,88,UNION,1609997,491231,1610460,682578,4114795,446628,955294,0,1720305,1671335,13302623,666123,0,13968746,0,4859236,18827982,POINT (-94.2423792 41.0277304)
2021_60_LYON_EXPEND_SA,2021,60,LYON,3655207,716271,360118,935408,7710099,458933,1199938,118922,631400,4207000,19993296,4314037,0,24307333,0,7273436,31580769,POINT (-96.2102924 43.380497)
2009_60_LYON_EXPEND_SA,2009,60,LYON,2475690,867394,1073393,756425,3409500,472788,912471,27000,252885,1054228,11301774,1219863,0,12521637,0,3421683,15943320,POINT (-96.2102924 43.380497)
2013_92_WASHINGTON_EXPEND_SA,2013,92,WASHINGTON,4625557,2555098,2393790,902005,5009058,668024,1961593,57500,3284270,6410766,27867661,2403615,0,30271276,0,3604250,33875526,POINT (-91.7178676 41.335591)
2015_26_DAVIS_EXPEND_SA,2015,26,DAVIS,1225253,396661,398063,365906,3487120,360553,931366,35493,73085,460000,7733500,780146,0,8513646,0,1989704,10503350,POINT (-92.4097173 40.7476891)
2016_88_UNION_EXPEND_SA,2016,88,UNION,1801389,419929,1150752,2038224,3587200,506867,1057147,0,1509683,194411,12265602,901161,0,13166763,0,1916645,15083408,POINT (-94.2423792 41.0277304)
2007_26_DAVIS_EXPEND_SA,2007,26,DAVIS,914130,314144,754000,260659,2909447,332317,836632,20000,0,170000,6511329,566143,,7077472,0,1517203,8594675,POINT (-92.4097173 40.7476891)
2011_15_CASS_EXPEND_SA,2011,15,CASS,2208058,517080,2567237,547099,4595000,424992,1120329,1624340,51563,1926860,15582558,1925599,0,17508157,0,602909,18111066,POINT (-94.9278266 41.3314876)
2008_98_WORTH_EXPEND_SA,2008,98,WORTH,1357915,1147435,877000,790394,2622000,287681,941896,0,477957,584820,9087098,985442,0,10072540,0,3374544,13447084,POINT (-93.2608476 43.3773984)
2014_96_WINNESHIEK_EXPEND_SA,2014,96,WINNESHIEK,2561165,1449800,1236016,1605533,5873040,575726,2055799,5500,0,4186000,19548579,2134003,0,21682582,0,5358276,27040858,POINT (-91.8437074 43.2906746)
2008_10_BUCHANAN_EXPEND_SA,2008,10,BUCHANAN,2310706,237879,2809885,892974,4818000,512148,2034073,43335,103705,761000,14523705,2129977,0,16653682,0,2164303,18817985,POINT (-91.8378392 42.4707777)
2006_37_GREENE_EXPEND_SA,2006,37,GREENE,988435,302986,1228100,749768,3252150,416117,1158826,7500,0,260500,8364382,868000,,9232382,0,1848976,11081358,POINT (-94.3968356 42.0362394)
2016_25_DALLAS_EXPEND_SA,2016,25,DALLAS,10196583,3255337,2534510,3205925,6789717,2318211,1751428,58000,1974471,5526360,37610542,5854906,0,43465448,0,22488923,65954371,POINT (-94.0397374 41.6848862)
2010_69_MONTGOMERY_EXPEND_SA,2010,69,MONTGOMERY,1847379,740082,1281672,315989,3051675,397023,829181,200,10088,893034,9366323,992198,0,10358521,0,2286533,12645054,POINT (-95.1563758 41.03014)
2022_93_WAYNE_EXPEND_SA,2022,93,WAYNE,2387065,1237188,267036,429827,4470750,366996,1267205,10000,253000,1565000,12254067,831315,0,13085382,0,3398615,16483997,POINT (-93.3273639 40.73947020000001)
2015_11_BUENA VISTA_EXPEND_SA,2015,11,BUENA VISTA,3759087,1357457,1277600,700945,4785525,785560,1860396,4900,957881,2354226,17843577,2397790,0,20241367,0,5021175,25262542,POINT (-95.15114900000002 42.7354936)
2019_50_JASPER_EXPEND_SA,2019,50,JASPER,7030355,2287431,1036568,1521000,9094016,1464540,3478369,109000,1738721,1829541,29589541,4549741,0,34139282,0,8212597,42351879,POINT (-93.053765 41.6860394)
2008_3_ALLAMAKEE_EXPEND_SA,2008,3,ALLAMAKEE,1252829,622824,2000491,861917,3739280,380162,964183,57283,0,450000,10328969,1209050,0,11538019,0,3160181,14698200,POINT (-91.3780923 43.2842838)
2019_92_WASHINGTON_EXPEND_SA,2019,92,WASHINGTON,5216828,2310834,827183,1266294,6464732,803140,2387824,5000,3146101,1793590,24221526,3152890,0,27374416,0,3207051,30581467,POINT (-91.7178676 41.335591)
2007_29_DES MOINES_EXPEND_SA,2007,29,DES MOINES,5262092,2561617,4267740,1819324,3813917,734170,5009960,0,199718,3045700,26714238,1716832,,28431070,0,3783211,32214281,POINT (-91.1814707 40.9231829)
2005_4_APPANOOSE_EXPEND_SA,2005,4,APPANOOSE,1481643,683240,1307203,258617,2958000,339850,704011,0,33440,1035000,8801004,482360,,9283364,0,4391763,13675127,POINT (-92.8686104 40.7431635)
2022_44_HENRY_EXPEND_SA,2022,44,HENRY,4714113,1468218,1097644,1197727,4931700,832969,1845223,68000,884825,923100,17963519,1698811,0,19662330,0,4362587,24024917,POINT (-91.5445241 40.9879383)
2018_78_POTTAWATTAMIE_EXPEND_SA,2018,78,POTTAWATTAMIE,30719905,3718447,3312475,6610606,15160290,2265099,7901842,0,2972408,6650000,79311072,7925000,0,87236072,0,28848615,116084687,POINT (-95.5423935 41.3366123)
2017_63_MARION_EXPEND_SA,2017,63,MARION,4705755,2674399,2713842,2047532,7187439,977345,2868398,0,460903,1937821,25573434,2335118,0,27908552,0,8311428,36219980,POINT (-93.0994367 41.3344515)
2020_12_BUTLER_EXPEND_SA,2020,12,BUTLER,2623048,1408354,696512,1331328,6075000,633844,2087792,2500,651410,2287739,17797527,3198302,0,20995829,0,6574989,27570818,POINT (-92.7901934 42.7315661)
2007_70_MUSCATINE_EXPEND_SA,2007,70,MUSCATINE,6288509,1433319,4608430,954771,4542000,809884,2224203,25000,3821700,3438000,28145816,867180,,29012996,0,2949979,31962975,POINT (-91.1127562 41.4839221)
2013_60_LYON_EXPEND_SA,2013,60,LYON,3047340,938756,1063182,871043,4530326,485576,1138384,90425,242423,472000,12879455,2022017,0,14901472,0,4579248,19480720,POINT (-96.2102924 43.380497)
2016_14_CARROLL_EXPEND_SA,2016,14,CARROLL,3775541,1266842,1071901,1075412,5453101,523746,1665154,0,0,1623371,16455068,2267822,0,18722890,0,5567320,24290210,POINT (-94.8605593 42.0362382)
2010_11_BUENA VISTA_EXPEND_SA,2010,11,BUENA VISTA,2761640,1227508,1622509,658462,4135310,634792,1255723,19050,1173475,1070938,14559407,1803003,0,16362410,0,3791598,20154008,POINT (-95.15114900000002 42.7354936)
2009_43_HARRISON_EXPEND_SA,2009,43,HARRISON,1984350,1950844,1787907,857854,5277500,505037,1256022,0,479574,2581900,16680988,1293465,0,17974453,0,4559240,22533693,POINT (-95.8169209 41.6828528)
2009_36_FREMONT_EXPEND_SA,2009,36,FREMONT,1743550,196002,1183901,675866,3459000,380145,1031924,4300,143445,320000,9138133,885094,0,10023227,0,3601594,13624821,POINT (-95.6046765 40.7455892)
2007_44_HENRY_EXPEND_SA,2007,44,HENRY,2510150,775152,2521593,756078,3250000,491451,1018953,32600,147473,1415572,12919022,863964,,13782986,0,2057014,15840000,POINT (-91.5445241 40.9879383)
2005_81_SAC_EXPEND_SA,2005,81,SAC,1339616,523905,1201164,517286,2961500,288903,854012,0,9250,1090000,8785636,799771,,9585407,0,1710313,11295720,POINT (-95.1053946 42.3862604)
2011_60_LYON_EXPEND_SA,2011,60,LYON,2672321,873695,986265,716751,3757860,438512,933028,35250,243100,282250,10939032,1440565,0,12379597,0,5079488,17459085,POINT (-96.2102924 43.380497)
2022_12_BUTLER_EXPEND_SA,2022,12,BUTLER,2708143,1550688,433170,1629244,6395000,669082,2423242,2500,1021305,2210500,19042874,4055000,0,23097874,0,2533525,25631399,POINT (-92.7901934 42.7315661)
2014_32_EMMET_EXPEND_SA,2014,32,EMMET,1708824,724291,763202,496689,3527370,469023,1201128,0,0,46938,8937465,868841,0,9806306,0,2246586,12052892,POINT (-94.6784803 43.37802250000001)
2006_69_MONTGOMERY_EXPEND_SA,2006,69,MONTGOMERY,1494605,780456,926627,484646,3178940,521223,728017,180,97525,507540,8719759,892070,,9611829,0,1460837,11072666,POINT (-95.1563758 41.03014)
2005_36_FREMONT_EXPEND_SA,2005,36,FREMONT,1555476,239823,1324109,614809,3662000,347412,875176,6300,0,146000,8771105,779945,,9551050,0,2386701,11937751,POINT (-95.6046765 40.7455892)
2011_65_MILLS_EXPEND_SA,2011,65,MILLS,2522883,1653962,1771649,911284,4854278,456290,1448297,0,104530,1012527,14735700,1605000,0,16340700,0,5771232,22111932,POINT (-95.62132670000001 41.0334523)
2020_78_POTTAWATTAMIE_EXPEND_SA,2020,78,POTTAWATTAMIE,32474119,4093212,2298951,7943933,18882785,2462714,8630099,0,3013290,3978500,83777603,7525000,0,91302603,0,37059448,128362051,POINT (-95.5423935 41.3366123)
2019_28_DELAWARE_EXPEND_SA,2019,28,DELAWARE,3072653,574533,1301114,1103383,6933671,739438,2192076,49800,664193,2584500,19215361,2712320,0,21927681,0,7682363,29610044,POINT (-91.3673502 42.471211)
2009_78_POTTAWATTAMIE_EXPEND_SA,2009,78,POTTAWATTAMIE,18100714,3382691,9739500,8072076,10818777,2032764,5480818,0,2209030,2427543,62263913,5028412,0,67292325,0,13561222,80853547,POINT (-95.5423935 41.3366123)
2015_87_TAYLOR_EXPEND_SA,2015,87,TAYLOR,1268519,1083852,298723,306979,3466000,342731,677138,0,977260,4533844,12955046,764590,0,13719636,0,1986788,15706424,POINT (-94.6964148 40.73743240000001)
2021_43_HARRISON_EXPEND_SA,2021,43,HARRISON,3193148,1872097,353350,1275056,6965000,657214,1591064,0,121125,1487400,17515454,2376000,0,19891454,0,7753314,27644768,POINT (-95.8169209 41.6828528)
2012_30_DICKINSON_EXPEND_SA,2012,30,DICKINSON,2260776,562504,1509948,2385990,3425965,651647,1914287,167000,1357252,1982086,16217455,2817850,0,19035305,0,7982456,27017761,POINT (-95.1508301 43.3779848)
2015_45_HOWARD_EXPEND_SA,2015,45,HOWARD,1560508,754394,628554,1566712,3976858,427295,1079710,10000,1551925,102281,11658237,1618367,0,13276604,0,3306406,16583010,POINT (-92.3171989 43.3567673)
2009_95_WINNEBAGO_EXPEND_SA,2009,95,WINNEBAGO,1750755,769011,1385000,606719,3122000,443850,896190,4500,0,305500,9283525,1541674,0,10825199,0,1902533,12727732,POINT (-93.7341955 43.37756780000001)
2011_82_SCOTT_EXPEND_SA,2011,82,SCOTT,27452851,6738506,15514595,4850337,4721000,2043870,9526913,0,4188885,3833658,78870615,8128064,0,86998679,0,14171143,101169822,POINT (-90.6232428 41.6370978)
2020_99_WRIGHT_EXPEND_SA,2020,99,WRIGHT,3550259,2124605,742768,1380292,5648750,629953,1952304,59175,5319075,4663000,26070181,2033483,0,28103664,0,3420086,31523750,POINT (-93.7351465 42.7331189)
2021_79_POWESHIEK_EXPEND_SA,2021,79,POWESHIEK,3566552,384061,453769,723524,7776690,676303,1406738,387284,740165,2070000,18185086,3938923,0,22124009,0,8806163,30930172,POINT (-92.53146840000001 41.6864422)
2018_18_CHEROKEE_EXPEND_SA,2018,18,CHEROKEE,2497594,395654,460682,1002453,6018984,563415,1535786,70000,0,3427723,15972291,2000000,0,17972291,0,5149240,23121531,POINT (-95.6238055 42.7356226)
2009_31_DUBUQUE_EXPEND_SA,2009,31,DUBUQUE,12504566,12729133,9493868,3236893,6247576,1407848,3071746,118650,498600,3100000,52408880,6283631,0,58692511,0,3860933,62553444,POINT (-90.8824564 42.468832)
2022_76_POCAHONTAS_EXPEND_SA,2022,76,POCAHONTAS,2601150,1640469,348549,1078577,5070290,423404,1781148,12385,0,1069101,14025073,1710286,0,15735359,0,11059344,26794703,POINT (-94.67874660000001 42.73413510000001)
2016_78_POTTAWATTAMIE_EXPEND_SA,2016,78,POTTAWATTAMIE,27565113,5499184,3560024,7555783,12997353,2083164,7121491,0,4398101,3125000,73905213,8825000,0,82730213,0,17246828,99977041,POINT (-95.5423935 41.3366123)
2017_16_CEDAR_EXPEND_SA,2017,16,CEDAR,3876175,1516165,1155940,1391249,6394100,515946,1640795,6200,0,1365000,17861570,2382066,0,20243636,0,3649063,23892699,POINT (-91.1324125 41.7723207)
2017_21_CLAY_EXPEND_SA,2017,21,CLAY,3059650,764698,503492,1426452,5437643,459323,1811381,0,492498,1988086,15943223,2502702,0,18445925,0,4846574,23292499,POINT (-95.1509194 43.0825804)
2010_95_WINNEBAGO_EXPEND_SA,2010,95,WINNEBAGO,1770565,818744,1449427,1589707,3006754,447829,905172,198454,77148,300746,10564546,1378060,0,11942606,0,2097149,14039755,POINT (-93.7341955 43.37756780000001)
2006_64_MARSHALL_EXPEND_SA,2006,64,MARSHALL,6047666,930298,3169859,856703,5111400,956548,2547716,0,655661,1711418,21987269,1747493,,23734762,0,2797308,26532070,POINT (-92.9987706 42.0358499)
2010_37_GREENE_EXPEND_SA,2010,37,GREENE,1329020,366596,1447159,935167,4104446,327853,1330301,0,0,175000,10015542,1270000,0,11285542,0,2303334,13588876,POINT (-94.3968356 42.0362394)
2014_54_KEOKUK_EXPEND_SA,2014,54,KEOKUK,1050912,702563,490075,356499,4006350,368607,2010725,0,0,546000,9531731,1309000,0,10840731,0,3691656,14532387,POINT (-92.1786426 41.336465)
2019_82_SCOTT_EXPEND_SA,2019,82,SCOTT,32352530,6187788,4555905,5225227,6838000,2758284,12033649,0,3385530,10274928,83611841,16105054,0,99716895,0,30820356,130537251,POINT (-90.6232428 41.6370978)
2013_4_APPANOOSE_EXPEND_SA,2013,4,APPANOOSE,2041263,849699,1177994,624751,3220000,504603,1017543,0,198432,455000,10089285,719108,0,10808393,0,6286078,17094471,POINT (-92.8686104 40.7431635)
2011_87_TAYLOR_EXPEND_SA,2011,87,TAYLOR,867143,1036156,555706,212100,3003000,302872,658304,0,199447,535000,7369728,689070,0,8058798,0,1704197,9762995,POINT (-94.6964148 40.73743240000001)
2011_70_MUSCATINE_EXPEND_SA,2011,70,MUSCATINE,7775611,1378284,5244247,2068666,5180000,834109,2624598,30000,4454874,6226665,35817054,1159370,0,36976424,0,2118817,39095241,POINT (-91.1127562 41.4839221)
2010_54_KEOKUK_EXPEND_SA,2010,54,KEOKUK,893125,640646,1052632,353211,3511000,336248,1478885,0,0,729000,8994747,1004000,0,9998747,0,5291954,15290701,POINT (-92.1786426 41.336465)
2019_35_FRANKLIN_EXPEND_SA,2019,35,FRANKLIN,1973758,2012539,371303,1956182,5918000,507625,2138946,6000,2428000,805000,18117353,2463531,0,20580884,0,15331671,35912555,POINT (-93.262473 42.7325458)
2014_37_GREENE_EXPEND_SA,2014,37,GREENE,1437035,490465,392486,785135,4291220,341325,1563998,60000,0,64500,9426164,1205000,0,10631164,0,3422838,14054002,POINT (-94.3968356 42.0362394)
2008_78_POTTAWATTAMIE_EXPEND_SA,2008,78,POTTAWATTAMIE,16700747,3297407,8793904,7224255,10077000,1845189,5172691,0,1692621,2409200,57213014,4925549,0,62138563,0,11993451,74132014,POINT (-95.5423935 41.3366123)
2007_58_LOUISA_EXPEND_SA,2007,58,LOUISA,1711288,600428,1327410,580658,2788730,271392,904617,0,53280,872066,9109869,1137061,,10246930,0,1671028,11917958,POINT (-91.2596184 41.2185073)
2022_2_ADAMS_EXPEND_SA,2022,2,ADAMS,1781584,224218,147790,1036878,4114532,414668,1059686,0,540705,105000,9425061,1385239,0,10810300,0,4262822,15073122,POINT (-94.6991849 41.02898390000001)
2017_90_WAPELLO_EXPEND_SA,2017,90,WAPELLO,4287650,1338834,1264061,894663,4760467,738988,3206355,93086,777864,3281607,20643575,1150000,0,21793575,0,8270108,30063683,POINT (-92.4094499 41.03058450000001)
2016_46_HUMBOLDT_EXPEND_SA,2016,46,HUMBOLDT,1963731,399103,752982,740452,3440239,461970,1155755,0,0,511000,9425232,1589733,0,11014965,0,4925089,15940054,POINT (-94.2071868 42.7764686)
2011_55_KOSSUTH_EXPEND_SA,2011,55,KOSSUTH,2663799,440837,2279091,834642,6231800,707127,1780434,68769,107100,1550000,16663599,2887951,0,19551550,0,6267808,25819358,POINT (-94.2067199 43.20413)
2007_12_BUTLER_EXPEND_SA,2007,12,BUTLER,1554801,1411077,1240000,702117,4077000,394268,1217397,7500,38943,1713413,12356516,1207190,,13563706,0,3478443,17042149,POINT (-92.7901934 42.7315661)
2009_92_WASHINGTON_EXPEND_SA,2009,92,WASHINGTON,3748273,2424672,2186335,710098,4367620,662331,1755624,55600,2010955,1735800,19657308,1764211,0,21421519,0,3041591,24463110,POINT (-91.7178676 41.335591)
2006_14_CARROLL_EXPEND_SA,2006,14,CARROLL,2325330,1013802,2767231,846968,3448600,535494,1153023,250000,36700,933700,13310848,1070000,,14380848,0,2925762,17306610,POINT (-94.8605593 42.0362382)
2013_21_CLAY_EXPEND_SA,2013,21,CLAY,2881518,565503,2029836,1406789,4537091,407973,1636102,0,269298,2486754,16220864,1127310,0,17348174,0,5519705,22867879,POINT (-95.1509194 43.0825804)
2020_25_DALLAS_EXPEND_SA,2020,25,DALLAS,13668134,2086560,3389485,3021969,9179371,2629019,2053039,100500,4134667,8247067,48509811,9221140,0,57730951,0,21407560,79138511,POINT (-94.0397374 41.6848862)
2015_92_WASHINGTON_EXPEND_SA,2015,92,WASHINGTON,4620762,2484406,781141,943809,5705090,703395,2026746,55000,2229913,1203946,20754208,2523849,0,23278057,0,3614119,26892176,POINT (-91.7178676 41.335591)
2012_57_LINN_EXPEND_SA,2012,57,LINN,23508797,15753884,37240499,6799417,12024770,3876866,12038258,22200,1175968,17286000,129726659,14519268,0,144245927,0,21214133,165460060,POINT (-91.5989646 42.0789478)
2011_24_CRAWFORD_EXPEND_SA,2011,24,CRAWFORD,1902676,2751458,2110250,869995,6568600,552402,1236641,0,246100,1096400,17334522,1837000,0,19171522,0,4821427,23992949,POINT (-95.3819678 42.0372125)
2010_22_CLAYTON_EXPEND_SA,2010,22,CLAYTON,2389070,578470,2068194,1155163,5781966,588994,1197951,1300,294725,1422000,15477833,1400000,0,16877833,0,4520350,21398183,POINT (-91.34143280000002 42.8447493)
2014_49_JACKSON_EXPEND_SA,2014,49,JACKSON,2083261,345065,1227912,1372957,4617107,637637,1557546,0,0,491705,12333190,940000,0,13273190,0,3949513,17222703,POINT (-90.5742294 42.1717426)
2018_54_KEOKUK_EXPEND_SA,2018,54,KEOKUK,1266215,742373,422605,391656,5395850,415772,2149086,0,0,1392816,12176373,1765000,0,13941373,0,4005817,17947190,POINT (-92.1786426 41.336465)
2008_46_HUMBOLDT_EXPEND_SA,2008,46,HUMBOLDT,1413934,333399,1391893,562155,2735241,381207,1015414,0,0,277000,8110243,1165392,0,9275635,0,3911530,13187165,POINT (-94.2071868 42.7764686)
2006_25_DALLAS_EXPEND_SA,2006,25,DALLAS,5309908,2838503,4067225,1976014,5182782,1946062,2304968,206929,1113628,542124,25488143,2215905,,27704048,0,6499327,34203375,POINT (-94.0397374 41.6848862)
2019_87_TAYLOR_EXPEND_SA,2019,87,TAYLOR,1660106,1373591,144000,341919,3995000,363462,928656,0,947890,900000,10654624,813427,0,11468051,0,2849073,14317124,POINT (-94.6964148 40.73743240000001)
2016_57_LINN_EXPEND_SA,2016,57,LINN,26043344,14653106,15678795,7187992,13009618,4395026,14284085,0,1932923,7931800,105116689,18723725,0,123840414,0,27939982,151780396,POINT (-91.5989646 42.0789478)
2015_29_DES MOINES_EXPEND_SA,2015,29,DES MOINES,6613609,1611534,2622271,2416601,5146301,1046389,3177991,0,744786,3042250,26421732,1830434,0,28252166,0,3848995,32101161,POINT (-91.1814707 40.9231829)
2008_59_LUCAS_EXPEND_SA,2008,59,LUCAS,929439,550146,1155268,221512,2597251,289129,878848,173148,107914,2090000,8992655,518010,0,9510665,0,456613,9967278,POINT (-93.3277207 41.0293738)
2012_62_MAHASKA_EXPEND_SA,2012,62,MAHASKA,2905762,837086,2748025,970679,5007500,639379,1344171,980000,8490,200000,15641092,1767856,0,17408948,0,6839859,24248807,POINT (-92.6409094 41.3352035)
2010_59_LUCAS_EXPEND_SA,2010,59,LUCAS,1010768,788514,1225943,268267,2701908,295449,912894,0,43788,2353315,9600846,574022,0,10174868,0,822777,10997645,POINT (-93.3277207 41.0293738)
2014_78_POTTAWATTAMIE_EXPEND_SA,2014,78,POTTAWATTAMIE,22628127,5994705,4355196,14268096,11801810,1860772,6720052,0,3802849,9154000,80585607,6050000,0,86635607,0,11126661,97762268,POINT (-95.5423935 41.3366123)
2009_63_MARION_EXPEND_SA,2009,63,MARION,3361111,2674920,2231868,1229518,5844139,886590,2094616,0,470031,1425000,20217793,1826283,0,22044076,0,7116881,29160957,POINT (-93.0994367 41.3344515)
2016_93_WAYNE_EXPEND_SA,2016,93,WAYNE,1517486,1314630,354580,349844,3095500,251404,839310,13000,272673,622500,8630927,533515,0,9164442,0,4136285,13300727,POINT (-93.3273639 40.73947020000001)
2013_32_EMMET_EXPEND_SA,2013,32,EMMET,1672654,719274,1926305,489310,3247731,440881,1151528,0,0,50719,9698402,873665,0,10572067,0,1437318,12009385,POINT (-94.6784803 43.37802250000001)
2013_45_HOWARD_EXPEND_SA,2013,45,HOWARD,1386408,708099,1206719,1440702,3489546,437529,1294312,1000,597405,392691,10954411,1110664,0,12065075,0,4118560,16183635,POINT (-92.3171989 43.3567673)
2020_67_MONONA_EXPEND_SA,2020,67,MONONA,2183357,525541,218500,936997,6862558,590321,1887071,0,0,1596592,14800937,1752460,0,16553397,0,4729127,21282524,POINT (-95.9599235 42.0516663)
2006_96_WINNESHIEK_EXPEND_SA,2006,96,WINNESHIEK,1764901,1435488,2486066,1161096,4685476,523375,1266547,5500,562031,2145500,16035980,1945823,,17981803,0,4712193,22693996,POINT (-91.8437074 43.2906746)
2006_47_IDA_EXPEND_SA,2006,47,IDA,554676,360958,580450,449341,2286000,281797,751754,0,0,400000,5664976,672051,,6337027,0,1766688,8103715,POINT (-95.5134962 42.3868747)
2015_60_LYON_EXPEND_SA,2015,60,LYON,3142501,904595,650021,865223,5051628,500021,1166813,77760,243723,1808620,14410905,2517236,0,16928141,0,5557558,22485699,POINT (-96.2102924 43.380497)
2020_63_MARION_EXPEND_SA,2020,63,MARION,5141260,3575831,1302536,1982251,7715747,984865,3946872,0,370418,1810000,26829780,2551595,0,29381375,0,7810210,37191585,POINT (-93.0994367 41.3344515)
2012_84_SIOUX_EXPEND_SA,2012,84,SIOUX,4082982,1504806,2752316,3549235,5951450,859508,2345847,3734500,894500,3756585,29431729,2438414,0,31870143,0,5562874,37433017,POINT (-96.1778827 43.0826174)
2022_66_MITCHELL_EXPEND_SA,2022,66,MITCHELL,2283354,1164274,318780,1610729,5530000,450625,2322855,0,4763000,950000,19393617,1402044,0,20795661,0,1680053,22475714,POINT (-92.7890315 43.3564124)
2005_49_JACKSON_EXPEND_SA,2005,49,JACKSON,1265245,383927,1927270,864253,3730360,357707,1004804,125929,120000,591896,10371391,750000,,11121391,0,3747867,14869258,POINT (-90.5742294 42.1717426)
2010_31_DUBUQUE_EXPEND_SA,2010,31,DUBUQUE,12628696,12930403,10048310,4467887,6574810,1464294,3079266,323800,500450,6670000,58687916,6179060,0,64866976,0,3009525,67876501,POINT (-90.8824564 42.468832)
2012_20_CLARKE_EXPEND_SA,2012,20,CLARKE,1689921,1015542,1013499,268711,2446276,384574,910851,0,289085,45000,8063459,599774,0,8663233,0,1777038,10440271,POINT (-93.78515790000002 41.0290323)
2010_63_MARION_EXPEND_SA,2010,63,MARION,3197401,2697719,2309255,1235732,6164699,698666,2218866,0,465232,775000,19762570,1940429,0,21702999,0,8535105,30238104,POINT (-93.0994367 41.3344515)
2015_14_CARROLL_EXPEND_SA,2015,14,CARROLL,3614607,1239624,1457333,1057179,5214500,505536,1764749,0,0,980000,15833528,2049000,0,17882528,0,5550684,23433212,POINT (-94.8605593 42.0362382)
2022_88_UNION_EXPEND_SA,2022,88,UNION,2100471,473373,500156,680433,4043359,554507,1210851,40000,1971673,1409031,12983854,1171771,0,14155625,0,2223328,16378953,POINT (-94.2423792 41.0277304)
2010_86_TAMA_EXPEND_SA,2010,86,TAMA,3166925,1428634,2039447,735726,6008964,495041,1319118,1250,0,1844774,17039879,1788319,0,18828198,0,1454435,20282633,POINT (-92.5325425 42.07981170000001)
2013_64_MARSHALL_EXPEND_SA,2013,64,MARSHALL,7259746,988706,4066900,1310041,6054000,968395,2547813,0,593550,440075,24229226,2184000,0,26413226,0,9006607,35419833,POINT (-92.9987706 42.0358499)
2011_97_WOODBURY_EXPEND_SA,2011,97,WOODBURY,12873949,5608222,12031883,2180999,7138768,2239705,6644493,20000,909430,3527287,53174736,6474178,0,59648914,0,5280401,64929315,POINT (-96.0447673 42.3897169)
2020_32_EMMET_EXPEND_SA,2020,32,EMMET,2273715,836343,357578,587770,3529313,570798,1485640,0,0,304860,9946017,1052789,0,10998806,0,5116862,16115668,POINT (-94.6784803 43.37802250000001)
2005_64_MARSHALL_EXPEND_SA,2005,64,MARSHALL,5866379,940288,3129705,693725,4787800,1035018,2421220,0,482661,1497404,20854200,1772000,,22626200,0,3001939,25628139,POINT (-92.9987706 42.0358499)
2021_15_CASS_EXPEND_SA,2021,15,CASS,3571321,521383,367020,769171,7148000,615676,1829464,303000,959205,4370660,20454900,4410154,0,24865054,0,4020813,28885867,POINT (-94.9278266 41.3314876)
2011_47_IDA_EXPEND_SA,2011,47,IDA,665064,321381,731421,366383,2630000,246652,750736,0,0,260000,5971637,987228,0,6958865,0,1461364,8420229,POINT (-95.5134962 42.3868747)
2015_36_FREMONT_EXPEND_SA,2015,36,FREMONT,1963572,309766,1522851,708184,4027000,449326,1355134,1500,483940,5357000,16178273,1150835,0,17329108,0,3648399,20977507,POINT (-95.6046765 40.7455892)
2007_98_WORTH_EXPEND_SA,2007,98,WORTH,1282085,1105664,877000,700571,2775000,279906,827801,0,344689,513500,8706216,695000,,9401216,0,3138148,12539364,POINT (-93.2608476 43.3773984)
2005_19_CHICKASAW_EXPEND_SA,2005,19,CHICKASAW,1122669,1303268,1100720,493452,3357300,377924,889889,0,0,260500,8905722,1802800,,10708522,0,4465076,15173598,POINT (-92.3176637 43.06004140000001)
2015_81_SAC_EXPEND_SA,2015,81,SAC,2304977,743968,645364,831824,4849800,471122,1348263,0,55000,1092000,12342318,1472774,0,13815092,0,3988469,17803561,POINT (-95.1053946 42.3862604)
2013_81_SAC_EXPEND_SA,2013,81,SAC,2208395,602628,1782309,767993,4338900,383368,1196185,0,55000,423000,11757778,1314077,0,13071855,0,3427911,16499766,POINT (-95.1053946 42.3862604)
2012_13_CALHOUN_EXPEND_SA,2012,13,CALHOUN,1944888,2339214,1345900,787816,4315290,548836,1030730,8750,0,881000,13202424,1460643,0,14663067,0,3087593,17750660,POINT (-94.6404136 42.385184800000005)
2007_85_STORY_EXPEND_SA,2007,85,STORY,8193586,1987200,8712215,2457203,4272300,1802434,4495528,0,1200323,861074,33981863,1601673,,35583536,0,5631871,41215407,POINT (-93.4650448 42.0362415)
2021_28_DELAWARE_EXPEND_SA,2021,28,DELAWARE,3537947,620449,1243926,1250253,7127814,1107747,2339740,52110,637200,3655000,21572186,3900423,0,25472609,0,9617700,35090309,POINT (-91.3673502 42.471211)
2016_68_MONROE_EXPEND_SA,2016,68,MONROE,1910710,856677,598103,764793,2625309,465060,1355877,0,725116,6970000,16271645,1535807,0,17807452,0,3623843,21431295,POINT (-92.8689877 41.0297826)
2017_38_GRUNDY_EXPEND_SA,2017,38,GRUNDY,2090341,563844,735278,950076,5039478,435667,2016416,0,1901501,3800478,17533079,1626808,0,19159887,0,3682723,22842610,POINT (-92.7914177 42.4018651)
2006_52_JOHNSON_EXPEND_SA,2006,52,JOHNSON,13300273,6721766,11179045,2451235,6476999,1924488,5968031,1950,0,3684181,51707968,10038213,,61746181,0,10963335,72709516,POINT (-91.5880849 41.6715511)
2022_61_MADISON_EXPEND_SA,2022,61,MADISON,3883107,889723,249547,3052052,6466652,794802,1676718,0,402237,1642159,19056997,2538136,0,21595133,0,6301219,27896352,POINT (-94.01556190000001 41.33071420000001)
2019_15_CASS_EXPEND_SA,2019,15,CASS,3429751,545132,476297,749243,5570000,647160,1578606,1118000,319595,6357126,20790910,4090043,0,24880953,0,5872023,30752976,POINT (-94.9278266 41.3314876)
2012_15_CASS_EXPEND_SA,2012,15,CASS,2234359,637435,2647673,452827,4383399,455856,1192805,1228540,111563,2056783,15401240,1800837,0,17202077,0,865765,18067842,POINT (-94.9278266 41.3314876)
2013_96_WINNESHIEK_EXPEND_SA,2013,96,WINNESHIEK,2434815,1527977,2933063,1540855,5576818,497936,1959537,6000,0,964000,17441001,2038060,0,19479061,0,5774965,25254026,POINT (-91.8437074 43.2906746)
2009_19_CHICKASAW_EXPEND_SA,2009,19,CHICKASAW,1334801,1389454,1102950,731285,2974000,412686,1040506,0,0,418000,9403682,2116788,0,11520470,0,4528844,16049314,POINT (-92.3176637 43.06004140000001)
2014_81_SAC_EXPEND_SA,2014,81,SAC,2257514,620713,794583,803532,4555300,401293,1274397,0,55000,1074000,11836332,1375705,0,13212037,0,2662889,15874926,POINT (-95.1053946 42.3862604)
2005_96_WINNESHIEK_EXPEND_SA,2005,96,WINNESHIEK,1685437,1444525,2195663,1166429,4017623,360919,1244777,8150,577783,1833250,14534556,1993463,,16528019,0,4874681,21402700,POINT (-91.8437074 43.2906746)
2020_82_SCOTT_EXPEND_SA,2020,82,SCOTT,34289553,6398499,5396295,5422061,7378600,2665913,12840617,0,3402239,11777170,89570947,15928447,0,105499394,0,30040016,135539410,POINT (-90.6232428 41.6370978)
2021_22_CLAYTON_EXPEND_SA,2021,22,CLAYTON,3446086,562560,532964,1372419,6900523,714290,1922616,1000,90850,1393008,16936316,2200000,0,19136316,0,5905395,25041711,POINT (-91.34143280000002 42.8447493)
2008_31_DUBUQUE_EXPEND_SA,2008,31,DUBUQUE,11663861,12480657,9394831,2886241,5883562,1342511,2893924,111000,500600,7262800,54419987,5922170,0,60342157,0,2124251,62466408,POINT (-90.8824564 42.468832)
2021_64_MARSHALL_EXPEND_SA,2021,64,MARSHALL,10277497,680478,1202985,1188383,8689049,986089,3124857,0,3101000,14480040,43730378,8104300,0,51834678,0,11161843,62996521,POINT (-92.9987706 42.0358499)
2014_64_MARSHALL_EXPEND_SA,2014,64,MARSHALL,7559562,991321,1938965,959608,6237600,871895,2916435,0,627900,825898,22929184,2456500,0,25385684,0,7743304,33128988,POINT (-92.9987706 42.0358499)
2017_65_MILLS_EXPEND_SA,2017,65,MILLS,3522532,1775099,400801,1357365,5851248,510027,1621101,0,540305,555000,16133478,2367608,0,18501086,0,4572553,23073639,POINT (-95.62132670000001 41.0334523)
2012_47_IDA_EXPEND_SA,2012,47,IDA,712894,329034,762128,354528,2802211,240693,701974,0,0,140000,6043462,793512,0,6836974,0,2386815,9223789,POINT (-95.5134962 42.3868747)
2018_82_SCOTT_EXPEND_SA,2018,82,SCOTT,31247900,6236276,4745428,4958041,6814000,2576624,11430905,0,3389950,7062376,78461500,14317925,0,92779425,0,27652160,120431585,POINT (-90.6232428 41.6370978)
2022_98_WORTH_EXPEND_SA,2022,98,WORTH,2659138,1117913,400027,1009880,4175104,488503,1761777,0,2273114,1480000,15365456,1334130,0,16699586,0,5603652,22303238,POINT (-93.2608476 43.3773984)
2022_71_O'BRIEN_EXPEND_SA,2022,71,O'BRIEN,4206648,571621,419329,1112875,5895257,751848,1505516,13200,0,2919000,17395294,4095309,0,21490603,0,3731661,25222264,POINT (-95.6248784 43.0837527)
2017_80_RINGGOLD_EXPEND_SA,2017,80,RINGGOLD,1343178,910499,585105,253721,3835443,285790,838237,0,486581,380000,8918554,735825,0,9654379,0,3887293,13541672,POINT (-94.2439719 40.7352023)
2020_47_IDA_EXPEND_SA,2020,47,IDA,981918,294408,211099,838629,3526396,328893,947187,0,586685,17120350,24835565,1487713,0,26323278,0,3145277,29468555,POINT (-95.5134962 42.3868747)
2009_14_CARROLL_EXPEND_SA,2009,14,CARROLL,2776914,1071335,3279504,1044843,4600800,533950,1150027,175000,91900,406905,15131178,1220000,0,16351178,0,3917918,20269096,POINT (-94.8605593 42.0362382)
2017_43_HARRISON_EXPEND_SA,2017,43,HARRISON,2798794,1734202,329452,1139588,6472000,600612,1453161,0,121055,1538050,16186914,2066000,0,18252914,0,9175405,27428319,POINT (-95.8169209 41.6828528)
2019_99_WRIGHT_EXPEND_SA,2019,99,WRIGHT,2912573,2615016,641081,1165686,5831500,585765,1780184,45520,544606,2723000,18844931,2038527,0,20883458,0,3311196,24194654,POINT (-93.7351465 42.7331189)
2007_66_MITCHELL_EXPEND_SA,2007,66,MITCHELL,1217613,848409,1409317,965336,3100000,245303,820839,500,339792,500000,9447109,973000,,10420109,0,1616501,12036610,POINT (-92.7890315 43.3564124)
2016_10_BUCHANAN_EXPEND_SA,2016,10,BUCHANAN,3457596,632899,1454690,1158360,6133800,718203,1607302,82182,605086,1350000,17200118,2496377,0,19696495,0,6600093,26296588,POINT (-91.8378392 42.4707777)
2008_14_CARROLL_EXPEND_SA,2008,14,CARROLL,2598961,1055021,2989193,885548,3633200,448300,1225221,200000,130000,796200,13961644,1075000,0,15036644,0,3333447,18370091,POINT (-94.8605593 42.0362382)
2015_4_APPANOOSE_EXPEND_SA,2015,4,APPANOOSE,2318055,933665,836709,762912,3573500,604703,1031838,0,215310,125000,10401692,754088,0,11155780,0,4851762,16007542,POINT (-92.8686104 40.7431635)
2022_29_DES MOINES_EXPEND_SA,2022,29,DES MOINES,9112603,1450801,1826796,1524856,6245985,1162782,3265979,0,3398000,1864000,29851802,2615990,0,32467792,0,5114989,37582781,POINT (-91.1814707 40.9231829)
2005_51_JEFFERSON_EXPEND_SA,2005,51,JEFFERSON,2023306,538494,1234524,475714,2418000,348584,832615,0,954923,426000,9252160,663633,,9915793,0,6916156,16831949,POINT (-91.9488774 41.0317596)
2015_64_MARSHALL_EXPEND_SA,2015,64,MARSHALL,7862128,1004484,1931719,976538,6142750,943737,2941353,0,749700,1581278,24133687,2846000,0,26979687,0,7640584,34620271,POINT (-92.9987706 42.0358499)
2020_15_CASS_EXPEND_SA,2020,15,CASS,3386380,527248,371508,770309,6669000,603049,1593081,1100000,157805,3892704,19071084,4143058,0,23214142,0,4318292,27532434,POINT (-94.9278266 41.3314876)
2005_68_MONROE_EXPEND_SA,2005,68,MONROE,1041445,696052,823737,225948,2147066,353605,1105799,0,274317,1817076,8485045,847142,,9332187,0,1896841,11229028,POINT (-92.8689877 41.0297826)
2007_2_ADAMS_EXPEND_SA,2007,2,ADAMS,723132,553600,414688,379265,2810000,197979,576368,43622,72369,966000,6737023,654550,,7391573,0,924410,8315983,POINT (-94.6991849 41.02898390000001)
2011_80_RINGGOLD_EXPEND_SA,2011,80,RINGGOLD,1337589,897818,927885,279523,2864905,259747,1423810,12500,0,90400,8094177,604681,0,8698858,0,1313504,10012362,POINT (-94.2439719 40.7352023)
2022_34_FLOYD_EXPEND_SA,2022,34,FLOYD,3661238,1480500,471780,792399,6338950,752542,1534229,0,1698745,3638743,20369126,1487866,0,21856992,0,4029012,25886004,POINT (-92.78900330000002 43.0599208)
2019_47_IDA_EXPEND_SA,2019,47,IDA,975474,299484,167640,433505,3695200,298842,898012,0,0,1181000,7949157,1251361,0,9200518,0,2538379,11738897,POINT (-95.5134962 42.3868747)
2018_14_CARROLL_EXPEND_SA,2018,14,CARROLL,3823016,1158346,987868,1163011,6461300,624691,1688021,0,19678,965900,16891831,3167252,0,20059083,0,5608790,25667873,POINT (-94.8605593 42.0362382)
2019_67_MONONA_EXPEND_SA,2019,67,MONONA,2153756,511774,186858,922975,6787445,539840,1926729,0,0,1275592,14304969,1697769,0,16002738,0,5426778,21429516,POINT (-95.9599235 42.0516663)
2021_54_KEOKUK_EXPEND_SA,2021,54,KEOKUK,1341017,777984,428637,386410,5405900,432178,1952172,0,202955,885400,11812653,2180955,0,13993608,0,3658567,17652175,POINT (-92.1786426 41.336465)
2006_79_POWESHIEK_EXPEND_SA,2006,79,POWESHIEK,2021495,419441,1613910,607984,4378600,749806,1044403,124493,174722,1061235,12196089,1488923,,13685012,0,3262797,16947809,POINT (-92.53146840000001 41.6864422)
2012_99_WRIGHT_EXPEND_SA,2012,99,WRIGHT,1896865,3277365,1596294,1026349,3945750,524786,1294980,22037,391080,3426000,17401506,1683164,0,19084670,0,3763948,22848618,POINT (-93.7351465 42.7331189)
2006_84_SIOUX_EXPEND_SA,2006,84,SIOUX,3141475,1126842,2553289,697742,4802975,957177,1738805,47750,474142,3401200,18941397,1390430,,20331827,0,1879644,22211471,POINT (-96.1778827 43.0826174)
2008_35_FRANKLIN_EXPEND_SA,2008,35,FRANKLIN,1767482,1546657,1209258,668939,3724266,375378,1479154,0,424825,233000,11428959,1340468,0,12769427,0,2765588,15535015,POINT (-93.262473 42.7325458)
2017_1_ADAIR_EXPEND_SA,2017,1,ADAIR,1451824,296945,265000,525247,4576222,404792,834103,0,1461196,7349111,17164440,1572406,0,18736846,0,4950902,23687748,POINT (-94.4709413 41.3307464)
2016_98_WORTH_EXPEND_SA,2016,98,WORTH,2240696,1168815,312609,1398245,3847269,402731,1409355,0,1753483,1047000,13580203,1536006,0,15116209,0,5289078,20405287,POINT (-93.2608476 43.3773984)
2009_46_HUMBOLDT_EXPEND_SA,2009,46,HUMBOLDT,1478208,343474,1476632,635029,2691603,454917,1021105,0,0,354000,8454968,1097465,0,9552433,0,4503084,14055517,POINT (-94.2071868 42.7764686)
2005_17_CERRO GORDO_EXPEND_SA,2005,17,CERRO GORDO,4692063,4070803,5200000,965919,4804586,856226,1991007,30000,466082,4126908,27203594,2742813,,29946407,0,5797582,35743989,POINT (-93.2608184 43.081557700000005)
2015_49_JACKSON_EXPEND_SA,2015,49,JACKSON,2144272,354292,1330094,1724294,4647005,647758,1707700,0,0,341402,12896817,1005544,0,13902361,0,4030614,17932975,POINT (-90.5742294 42.1717426)
2010_91_WARREN_EXPEND_SA,2010,91,WARREN,4243286,2982807,4151453,1057782,6652098,784197,2570733,10000,443505,1826768,24722629,2121706,0,26844335,0,4769024,31613359,POINT (-93.5613594 41.3343735)
2008_74_PALO ALTO_EXPEND_SA,2008,74,PALO ALTO,1383334,348657,1620440,1481116,3392071,357682,1091612,105000,274674,403020,10457606,1005709,0,11463315,0,4229642,15692957,POINT (-94.6781371 43.0820643)
2012_25_DALLAS_EXPEND_SA,2012,25,DALLAS,8157315,2900193,4660413,3266155,7053894,1892739,1769324,33000,1694815,4309715,35737563,3799714,0,39537277,0,13777230,53314507,POINT (-94.0397374 41.6848862)
2010_8_BOONE_EXPEND_SA,2010,8,BOONE,3074826,773271,2735554,2177108,5399450,643262,1802674,540000,699231,1580700,19426076,2025354,0,21451430,0,2966453,24417883,POINT (-93.931671 42.0365493)
2013_49_JACKSON_EXPEND_SA,2013,49,JACKSON,1905785,327797,2689821,1477708,4516341,596842,1453157,121900,0,524922,13614273,990000,0,14604273,0,4067309,18671582,POINT (-90.5742294 42.1717426)
2017_75_PLYMOUTH_EXPEND_SA,2017,75,PLYMOUTH,3813228,415190,375159,1047056,8748000,860782,2541154,0,1280908,3100000,22181477,4140000,0,26321477,0,4238541,30560018,POINT (-96.2140431 42.7378346)
2017_48_IOWA_EXPEND_SA,2017,48,IOWA,4758675,1201832,814994,1073277,6535600,659774,1603655,78611,282410,1244000,18252828,1315000,0,19567828,0,6883345,26451173,POINT (-92.065524 41.6863229)
2009_68_MONROE_EXPEND_SA,2009,68,MONROE,1253193,864472,1083942,293684,2318578,476064,995575,0,106094,974500,8366102,884187,0,9250289,0,1115337,10365626,POINT (-92.8689877 41.0297826)
2006_29_DES MOINES_EXPEND_SA,2006,29,DES MOINES,4784487,2478928,4754226,1840637,3725007,779773,4976545,0,178325,2974700,26492628,1406661,,27899289,0,3040272,30939561,POINT (-91.1814707 40.9231829)
2018_31_DUBUQUE_EXPEND_SA,2018,31,DUBUQUE,15563810,4996267,3770697,3315030,9986000,1854382,4829707,1585540,3022771,9243950,58168154,4984021,0,63152175,0,21419540,84571715,POINT (-90.8824564 42.468832)
2022_81_SAC_EXPEND_SA,2022,81,SAC,3203023,793426,379119,1190189,5545428,558159,1617413,0,46923,2425000,15758680,1737879,0,17496559,0,2513025,20009584,POINT (-95.1053946 42.3862604)
2008_42_HARDIN_EXPEND_SA,2008,42,HARDIN,3042982,424891,1918411,815269,4005072,431196,1441326,80321,613294,1007600,13780362,1957910,0,15738272,0,4949728,20688000,POINT (-93.2404025 42.3838803)
2015_96_WINNESHIEK_EXPEND_SA,2015,96,WINNESHIEK,2720962,1422318,1556884,1734727,6226400,585978,2166746,5500,0,4986000,21405515,2337543,0,23743058,0,3772859,27515917,POINT (-91.8437074 43.2906746)
2009_75_PLYMOUTH_EXPEND_SA,2009,75,PLYMOUTH,2802976,282136,1723522,902615,6086000,684060,2635109,0,1258581,1184000,17558999,2931875,0,20490874,0,2105910,22596784,POINT (-96.2140431 42.7378346)
2010_82_SCOTT_EXPEND_SA,2010,82,SCOTT,21096860,6450593,15717029,4478290,4646000,2160977,9179333,0,3460705,5439165,72628952,8310159,0,80939111,0,13014201,93953312,POINT (-90.6232428 41.6370978)
2021_75_PLYMOUTH_EXPEND_SA,2021,75,PLYMOUTH,4513177,413792,762799,1277424,8858000,922522,3425434,0,629620,3200000,24002768,4675000,0,28677768,0,7367502,36045270,POINT (-96.2140431 42.7378346)
2020_54_KEOKUK_EXPEND_SA,2020,54,KEOKUK,1227075,711697,345343,394321,6247600,418430,1933600,0,201395,2041421,13520882,2087395,0,15608277,0,3055079,18663356,POINT (-92.1786426 41.336465)
2014_61_MADISON_EXPEND_SA,2014,61,MADISON,2542024,779206,746031,721770,4357050,470407,974786,0,96850,614362,11302486,1557236,0,12859722,0,2925575,15785297,POINT (-94.01556190000001 41.33071420000001)
2013_17_CERRO GORDO_EXPEND_SA,2013,17,CERRO GORDO,7952672,5471986,2439186,1286622,5367972,1146761,2826769,0,992258,2120000,29604226,5330517,0,34934743,0,11134860,46069603,POINT (-93.2608184 43.081557700000005)
2021_96_WINNESHIEK_EXPEND_SA,2021,96,WINNESHIEK,4491477,1561625,600870,2931239,7515900,691890,2849715,4500,0,5010000,25657216,2719344,0,28376560,0,7415509,35792069,POINT (-91.8437074 43.2906746)
2008_63_MARION_EXPEND_SA,2008,63,MARION,2807300,2151056,2457112,1207562,5628418,672110,2211187,0,461311,1265000,18861056,1694605,0,20555661,0,4688445,25244106,POINT (-93.0994367 41.3344515)
2016_42_HARDIN_EXPEND_SA,2016,42,HARDIN,3742259,298740,1135045,949475,5449273,631772,1768522,1084062,2499762,790690,18349600,1963645,0,20313245,0,6054438,26367683,POINT (-93.2404025 42.3838803)
2020_95_WINNEBAGO_EXPEND_SA,2020,95,WINNEBAGO,2388648,1656754,664429,995505,3788230,702734,1414794,8500,3232840,2544079,17396513,1786624,0,19183137,0,7480207,26663344,POINT (-93.7341955 43.37756780000001)
2017_98_WORTH_EXPEND_SA,2017,98,WORTH,2232502,1019303,271527,921144,4286770,416802,1455332,0,2302386,697000,13602766,1293306,0,14896072,0,7067399,21963471,POINT (-93.2608476 43.3773984)
2022_56_LEE_EXPEND_SA,2022,56,LEE,10282537,5083879,1456267,1910803,6897757,1458246,2671507,28510,1092380,6844637,37726523,2611758,0,40338281,0,9354741,49693022,POINT (-91.479264 40.6419764)
2017_31_DUBUQUE_EXPEND_SA,2017,31,DUBUQUE,15119454,3489673,3780364,2739071,8064451,1563688,5429058,1557013,2888334,17871050,62502156,8451404,0,70953560,0,37476315,108429875,POINT (-90.8824564 42.468832)
2018_50_JASPER_EXPEND_SA,2018,50,JASPER,6633920,4589688,819925,1474401,11280277,1391701,3342902,29000,1786701,1647000,32995515,4247438,0,37242953,0,2634662,39877615,POINT (-93.053765 41.6860394)
2011_50_JASPER_EXPEND_SA,2011,50,JASPER,4939173,1950068,4434959,1317225,7287381,977546,2903044,14700,1828585,2600362,28253043,4812450,0,33065493,0,6015630,39081123,POINT (-93.053765 41.6860394)
2017_33_FAYETTE_EXPEND_SA,2017,33,FAYETTE,3893482,538297,1150634,1671502,6351726,832054,1708250,27400,400000,3022850,19596195,1980429,0,21576624,0,2634292,24210916,POINT (-91.8443207 42.8625919)
2010_50_JASPER_EXPEND_SA,2010,50,JASPER,4821807,1933826,4853233,1328015,5833213,960066,2813684,14000,1833500,1179292,25570636,4358479,0,29929115,0,6049585,35978700,POINT (-93.053765 41.6860394)
2014_17_CERRO GORDO_EXPEND_SA,2014,17,CERRO GORDO,8195559,5229894,2266829,1308836,5968391,1163784,2987509,0,992708,1185000,29298510,5556326,0,34854836,0,10794751,45649587,POINT (-93.2608184 43.081557700000005)
2005_32_EMMET_EXPEND_SA,2005,32,EMMET,1121930,568281,1469347,336221,2504013,312752,805875,0,28821,337334,7484574,542180,,8026754,0,1327421,9354175,POINT (-94.6784803 43.37802250000001)
2019_19_CHICKASAW_EXPEND_SA,2019,19,CHICKASAW,2214245,1538702,602336,722038,5641046,487501,1662303,0,0,1455954,14324125,2176300,0,16500425,0,4195941,20696366,POINT (-92.3176637 43.06004140000001)
2018_72_OSCEOLA_EXPEND_SA,2018,72,OSCEOLA,1646881,236089,131922,578997,3758366,311157,947123,150078,464709,90000,8315322,1762474,0,10077796,0,5964148,16041944,POINT (-95.6236852 43.3785704)
2012_52_JOHNSON_EXPEND_SA,2012,52,JOHNSON,21303843,8853781,13676625,3553539,7660582,2292149,7518174,3000,3372303,8419353,76653349,22161443,0,98814792,0,14278028,113092820,POINT (-91.5880849 41.6715511)
2020_59_LUCAS_EXPEND_SA,2020,59,LUCAS,1333705,604826,500499,458159,4175274,353553,1344945,0,0,488000,9258961,741774,0,10000735,0,971046,10971781,POINT (-93.3277207 41.0293738)
2022_84_SIOUX_EXPEND_SA,2022,84,SIOUX,5114000,941197,1027498,1988893,8574050,1282679,3081639,56600,741750,7271800,30080106,4510791,0,34590897,0,18694846,53285743,POINT (-96.1778827 43.0826174)
2008_40_HAMILTON_EXPEND_SA,2008,40,HAMILTON,2343324,2232990,2103967,1106155,4144045,426528,1129838,0,415657,1138000,15040504,1538202,0,16578706,0,3075993,19654699,POINT (-93.7068085 42.3837722)
2017_70_MUSCATINE_EXPEND_SA,2017,70,MUSCATINE,9794503,1217212,2293507,1292027,6660000,870163,3037495,0,2381350,4952000,32498257,2361000,0,34859257,0,10389578,45248835,POINT (-91.1127562 41.4839221)
2012_11_BUENA VISTA_EXPEND_SA,2012,11,BUENA VISTA,3011178,1250947,1758883,725877,4389865,695603,1421078,4500,1045251,1469918,15773100,2087260,0,17860360,0,4968777,22829137,POINT (-95.15114900000002 42.7354936)
2016_53_JONES_EXPEND_SA,2016,53,JONES,2596966,798438,1373463,1053631,6261929,818714,1791626,88687,500,1145000,15928954,2035000,0,17963954,0,5324125,23288079,POINT (-91.1314352 42.1212397)
2020_52_JOHNSON_EXPEND_SA,2020,52,JOHNSON,27335209,12357128,7868986,6032502,10653012,2854874,11242176,52790,22003725,20613258,121013660,17254135,0,138267795,0,23677104,161944899,POINT (-91.5880849 41.6715511)
2011_63_MARION_EXPEND_SA,2011,63,MARION,3347356,2546459,2054572,1307884,6080592,711411,2227644,0,557855,2064775,20898548,1964704,0,22863252,0,9739964,32603216,POINT (-93.0994367 41.3344515)
2015_34_FLOYD_EXPEND_SA,2015,34,FLOYD,2574909,1617064,887831,2306745,5332550,665009,1224556,0,566228,952000,16126892,1233186,0,17360078,0,6199969,23560047,POINT (-92.78900330000002 43.0599208)
2022_20_CLARKE_EXPEND_SA,2022,20,CLARKE,2601776,910738,395526,379539,4458700,641238,1311413,0,85040,25000,10808970,926819,0,11735789,0,2747405,14483194,POINT (-93.78515790000002 41.0290323)
2011_20_CLARKE_EXPEND_SA,2011,20,CLARKE,1682209,925096,1066990,244880,2590750,368911,816842,0,195465,44000,7935143,581582,0,8516725,0,1100563,9617288,POINT (-93.78515790000002 41.0290323)
2017_34_FLOYD_EXPEND_SA,2017,34,FLOYD,2857705,1359558,1124064,1069054,5919250,648849,1321791,0,819799,438000,15558070,1234741,0,16792811,0,5488265,22281076,POINT (-92.78900330000002 43.0599208)
2006_56_LEE_EXPEND_SA,2006,56,LEE,3392910,3855696,4295811,1362693,3998482,1231739,2136295,0,154640,930000,21358266,1005000,,22363266,0,3622345,25985611,POINT (-91.479264 40.6419764)
2017_97_WOODBURY_EXPEND_SA,2017,97,WOODBURY,16962590,4954560,2854210,2582947,8465786,2619118,6409175,20000,1340550,9069041,55277977,9399770,0,64677747,0,11850345,76528092,POINT (-96.0447673 42.3897169)
2018_67_MONONA_EXPEND_SA,2018,67,MONONA,2050777,528933,206517,895337,6418097,499864,1746717,0,0,1383092,13729334,1676003,0,15405337,0,5281527,20686864,POINT (-95.9599235 42.0516663)
2011_7_BLACK HAWK_EXPEND_SA,2011,7,BLACK HAWK,17436234,8267728,8544500,5303350,5312684,1614940,5749925,0,4535792,11485000,68250153,2129046,0,70379199,0,8617031,78996230,POINT (-92.3088197 42.4700957)
2020_1_ADAIR_EXPEND_SA,2020,1,ADAIR,1852009,296837,263000,553259,5326923,490369,1012979,0,2261347,9999739,22056462,1491739,0,23548201,0,9398189,32946390,POINT (-94.4709413 41.3307464)
2015_63_MARION_EXPEND_SA,2015,63,MARION,3920629,2488885,1125940,1803259,6132483,846239,2716099,0,446901,1427350,20907785,2263389,0,23171174,0,11565022,34736196,POINT (-93.0994367 41.3344515)
2020_22_CLAYTON_EXPEND_SA,2020,22,CLAYTON,3278483,521807,634184,1347890,7153088,701738,1926427,1000,349545,2326494,18240656,1750000,0,19990656,0,4061849,24052505,POINT (-91.34143280000002 42.8447493)
2013_73_PAGE_EXPEND_SA,2013,73,PAGE,1756110,678913,2084217,478970,3513003,482363,1172349,4000,209855,225196,10604976,1134470,0,11739446,0,4632440,16371886,POINT (-95.1501747 40.7391444)
2022_67_MONONA_EXPEND_SA,2022,67,MONONA,2395913,454601,198145,1001846,6499608,620298,1875271,0,0,1383592,14429274,1578086,0,16007360,0,5581519,21588879,POINT (-95.9599235 42.0516663)
2005_12_BUTLER_EXPEND_SA,2005,12,BUTLER,1421852,1279420,1200000,626684,3795000,325997,1182130,0,49355,1084000,10964438,1111925,,12076363,0,4128001,16204364,POINT (-92.7901934 42.7315661)
2019_42_HARDIN_EXPEND_SA,2019,42,HARDIN,5059095,474554,678025,1154648,6655917,750018,2253346,449737,1957317,275300,19707957,2206398,0,21914355,0,7034254,28948609,POINT (-93.2404025 42.3838803)
2020_20_CLARKE_EXPEND_SA,2020,20,CLARKE,2345606,1035699,371932,358177,4165100,576889,1552070,0,52625,775000,11233098,823138,0,12056236,0,2453375,14509611,POINT (-93.78515790000002 41.0290323)
2012_35_FRANKLIN_EXPEND_SA,2012,35,FRANKLIN,1680056,1951158,1426923,780310,4271000,469984,1538776,0,870998,9143308,22132513,1695343,0,23827856,0,3015586,26843442,POINT (-93.262473 42.7325458)
2005_73_PAGE_EXPEND_SA,2005,73,PAGE,1251701,860035,1575551,230187,3930500,334620,762841,1000,0,642500,9588935,764958,,10353893,0,1551126,11905019,POINT (-95.1501747 40.7391444)
2021_2_ADAMS_EXPEND_SA,2021,2,ADAMS,1864865,219827,148000,879595,3729790,388586,955880,0,876883,939936,10003362,1167089,0,11170451,0,3701044,14871495,POINT (-94.6991849 41.02898390000001)
2006_77_POLK_EXPEND_SA,2006,77,POLK,44517541,26545427,43071013,14367996,9060637,5681985,25049195,50000,5316594,6609103,180269491,13335281,,193604772,0,50453742,244058514,POINT (-93.5735335 41.6855048)
2016_6_BENTON_EXPEND_SA,2016,6,BENTON,4074199,944091,1098063,2484009,7349972,771915,2032043,165000,196024,1959794,21075110,3970342,0,25045452,0,7976570,33022022,POINT (-92.0656912 42.0801864)
2014_88_UNION_EXPEND_SA,2014,88,UNION,1680750,569966,724691,1140441,3377855,457634,975073,0,1536145,94107,10556662,856304,0,11412966,0,1622186,13035152,POINT (-94.2423792 41.0277304)
2016_52_JOHNSON_EXPEND_SA,2016,52,JOHNSON,23116404,9411761,7852904,4144391,8754380,2402067,8486697,89500,14512641,13609790,92380535,20826561,0,113207096,0,21930424,135137520,POINT (-91.5880849 41.6715511)
2008_90_WAPELLO_EXPEND_SA,2008,90,WAPELLO,3319905,1729824,4394000,835191,3323500,557768,2641424,118516,0,1220000,18140128,650000,0,18790128,0,6438388,25228516,POINT (-92.4094499 41.03058450000001)
2021_87_TAYLOR_EXPEND_SA,2021,87,TAYLOR,1840155,1459077,159000,598959,4299150,391933,962330,0,962740,646701,11320045,962162,0,12282207,0,3765125,16047332,POINT (-94.6964148 40.73743240000001)
2015_19_CHICKASAW_EXPEND_SA,2015,19,CHICKASAW,1983419,1656623,824693,733949,4941442,473192,1489346,2013,0,188649,12293326,1682564,0,13975890,0,3922199,17898089,POINT (-92.3176637 43.06004140000001)
2022_35_FRANKLIN_EXPEND_SA,2022,35,FRANKLIN,2205248,1481339,884701,1043301,6340000,610048,2347430,0,3374550,200000,18486617,2995497,0,21482114,0,10745771,32227885,POINT (-93.262473 42.7325458)
2008_18_CHEROKEE_EXPEND_SA,2008,18,CHEROKEE,1530314,453577,1389868,624244,3389250,362564,1093072,0,0,1984000,10826889,1034000,0,11860889,0,2650637,14511526,POINT (-95.6238055 42.7356226)
2009_51_JEFFERSON_EXPEND_SA,2009,51,JEFFERSON,2669737,562815,1371785,593629,2680500,467428,789686,0,161458,200000,9497038,879193,0,10376231,0,2511519,12887750,POINT (-91.9488774 41.0317596)
2010_77_POLK_EXPEND_SA,2010,77,POLK,60092491,30703480,51381904,15322769,9710380,6538709,33240269,100000,13173861,11618918,231882781,14429478,0,246312259,0,48786858,295099117,POINT (-93.5735335 41.6855048)
2018_86_TAMA_EXPEND_SA,2018,86,TAMA,3902979,1602582,1064071,907616,8175718,536907,1656326,39500,571135,1687707,20144541,2455465,0,22600006,0,7332293,29932299,POINT (-92.5325425 42.07981170000001)
2011_2_ADAMS_EXPEND_SA,2011,2,ADAMS,980826,291414,446174,535751,2864000,219130,656208,32266,516887,30000,6572656,743800,0,7316456,0,2620691,9937147,POINT (-94.6991849 41.02898390000001)
2017_85_STORY_EXPEND_SA,2017,85,STORY,11306800,2531098,1562480,3830946,6223800,1375385,5436953,0,1195543,4126204,37589209,3020422,0,40609631,0,14369518,54979149,POINT (-93.4650448 42.0362415)
2011_19_CHICKASAW_EXPEND_SA,2011,19,CHICKASAW,1433501,1383348,1068570,769215,3948135,366052,1283680,0,0,1064218,11316719,1957788,0,13274507,0,4358994,17633501,POINT (-92.3176637 43.06004140000001)
2006_45_HOWARD_EXPEND_SA,2006,45,HOWARD,971920,483184,1089623,843160,2606010,239338,685502,1000,30408,432731,7382876,883700,,8266576,0,2149220,10415796,POINT (-92.3171989 43.3567673)
2010_3_ALLAMAKEE_EXPEND_SA,2010,3,ALLAMAKEE,1441790,710556,2103684,861560,4754547,415138,939552,81400,0,1032000,12340227,1429029,0,13769256,0,3005502,16774758,POINT (-91.3780923 43.2842838)
2005_44_HENRY_EXPEND_SA,2005,44,HENRY,2053055,1061617,2363462,706184,3249050,450663,978790,32600,0,968197,11863618,856209,,12719827,0,2250567,14970394,POINT (-91.5445241 40.9879383)
2013_85_STORY_EXPEND_SA,2013,85,STORY,10000722,2170960,10927075,2592150,5563250,1240990,4763145,0,2280126,667000,40205418,2095000,0,42300418,0,6754485,49054903,POINT (-93.4650448 42.0362415)
2013_68_MONROE_EXPEND_SA,2013,68,MONROE,1439623,863160,1173046,1063676,2464862,414423,1149739,0,547873,1006000,10122402,1005521,0,11127923,0,1827070,12954993,POINT (-92.8689877 41.0297826)
2017_53_JONES_EXPEND_SA,2017,53,JONES,2611781,772672,1286307,996603,6492164,683396,1729242,103810,412500,1322000,16410475,2082000,0,18492475,0,7404647,25897122,POINT (-91.1314352 42.1212397)
2015_2_ADAMS_EXPEND_SA,2015,2,ADAMS,1241798,232054,184912,754125,3080000,300043,729818,360000,460930,35500,7379180,895421,0,8274601,0,1782123,10056724,POINT (-94.6991849 41.02898390000001)
2021_34_FLOYD_EXPEND_SA,2021,34,FLOYD,3580388,1433518,477030,831404,7128050,753835,1655290,0,1701395,5150891,22711801,1485917,0,24197718,0,5459389,29657107,POINT (-92.78900330000002 43.0599208)
2013_54_KEOKUK_EXPEND_SA,2013,54,KEOKUK,1116897,686336,1050274,354983,5062500,362853,2102590,0,0,389000,11125433,1271500,0,12396933,0,3508940,15905873,POINT (-92.1786426 41.336465)
2019_36_FREMONT_EXPEND_SA,2019,36,FREMONT,3091457,302325,146097,472969,4283000,523488,1705077,10000,462730,459000,11456143,1330499,0,12786642,0,3082021,15868663,POINT (-95.6046765 40.7455892)
2007_53_JONES_EXPEND_SA,2007,53,JONES,1871684,803182,2450739,576043,4725649,451327,1191692,234941,6377,2235130,14546764,1237500,,15784264,0,2144870,17929134,POINT (-91.1314352 42.1212397)
2009_70_MUSCATINE_EXPEND_SA,2009,70,MUSCATINE,6553495,1486042,5268958,959104,4575000,778035,2309690,30000,4003455,1889000,27852779,1257533,0,29110312,0,3531218,32641530,POINT (-91.1127562 41.4839221)
2007_34_FLOYD_EXPEND_SA,2007,34,FLOYD,1910345,1262359,1888125,787438,3924150,582307,971889,0,279123,273000,11878736,913313,,12792049,0,6210036,19002085,POINT (-92.78900330000002 43.0599208)
2011_34_FLOYD_EXPEND_SA,2011,34,FLOYD,2267675,1723458,856720,1841011,10594306,580191,1428471,0,182643,698000,20172475,919000,0,21091475,0,4524676,25616151,POINT (-92.78900330000002 43.0599208)
2018_30_DICKINSON_EXPEND_SA,2018,30,DICKINSON,2776995,550321,537494,3968493,4994600,915199,2471145,167500,1559121,2290284,20231152,3512776,0,23743928,0,7813808,31557736,POINT (-95.1508301 43.3779848)
2021_66_MITCHELL_EXPEND_SA,2021,66,MITCHELL,2199394,1178514,318870,1789282,4900000,444075,2766044,0,5501260,750000,19847439,1428508,0,21275947,0,3078963,24354910,POINT (-92.7890315 43.3564124)
2009_55_KOSSUTH_EXPEND_SA,2009,55,KOSSUTH,2673315,454794,2044645,776594,6035000,729187,1772798,67689,107024,1460000,16121046,2164962,0,18286008,0,4239636,22525644,POINT (-94.2067199 43.20413)
2015_95_WINNEBAGO_EXPEND_SA,2015,95,WINNEBAGO,1726358,1189924,848210,910528,3140164,526465,1601294,120351,2488619,1059736,13611649,1603228,0,15214877,0,881515,16096392,POINT (-93.7341955 43.37756780000001)
2019_74_PALO ALTO_EXPEND_SA,2019,74,PALO ALTO,2195452,523224,193000,1766784,5758850,509332,1383187,0,1892908,3090187,17312924,2624926,0,19937850,0,8434489,28372339,POINT (-94.6781371 43.0820643)
2006_1_ADAIR_EXPEND_SA,2006,1,ADAIR,800017,223206,679589,282932,3435453,300297,548899,0,174508,325000,6769901,983162,,7753063,0,2316104,10069167,POINT (-94.4709413 41.3307464)
2016_92_WASHINGTON_EXPEND_SA,2016,92,WASHINGTON,4812559,2355736,1040869,1061278,5846207,722038,2160069,55000,1273600,1354500,20681856,2603750,0,23285606,0,3426103,26711709,POINT (-91.7178676 41.335591)
2008_67_MONONA_EXPEND_SA,2008,67,MONONA,1581537,729920,920443,514276,3554035,379209,1361724,0,51974,662500,9755618,879754,0,10635372,0,2528207,13163579,POINT (-95.9599235 42.0516663)
2010_62_MAHASKA_EXPEND_SA,2010,62,MAHASKA,2760917,888372,2699999,883696,4967000,629869,1362581,1028150,8490,10000,15239074,1646197,0,16885271,0,8660117,25545388,POINT (-92.6409094 41.3352035)
2014_41_HANCOCK_EXPEND_SA,2014,41,HANCOCK,1563894,348681,561649,558417,4988300,425201,973063,11700,0,787625,10218530,2085000,0,12303530,0,2822046,15125576,POINT (-93.7342723 43.0818861)
2022_3_ALLAMAKEE_EXPEND_SA,2022,3,ALLAMAKEE,3078411,672353,411762,1391701,7216022,674216,1299302,20750,465647,1700000,16930164,2111630,0,19041794,0,3009380,22051174,POINT (-91.3780923 43.2842838)
2010_45_HOWARD_EXPEND_SA,2010,45,HOWARD,1255051,420554,1301303,1695286,3034852,354637,883014,1000,80895,382289,9408881,890112,0,10298993,0,2681305,12980298,POINT (-92.3171989 43.3567673)
2020_69_MONTGOMERY_EXPEND_SA,2020,69,MONTGOMERY,3584841,543394,253425,466681,4410440,551730,1366514,0,1261088,439429,12877542,1090000,0,13967542,0,2632510,16600052,POINT (-95.1563758 41.03014)
2005_88_UNION_EXPEND_SA,2005,88,UNION,1131307,350459,1352797,311916,2225938,319468,809405,0,542370,120000,7163660,509151,,7672811,0,1564392,9237203,POINT (-94.2423792 41.0277304)
2009_87_TAYLOR_EXPEND_SA,2009,87,TAYLOR,769509,1035548,597431,221644,2717000,319882,633915,0,205221,141000,6641150,656987,0,7298137,0,1318609,8616746,POINT (-94.6964148 40.73743240000001)
2007_6_BENTON_EXPEND_SA,2007,6,BENTON,2718137,705780,1611120,1378983,5627793,524849,1423640,0,0,1706354,15696656,2577219,,18273875,0,4785765,23059640,POINT (-92.0656912 42.0801864)
2011_78_POTTAWATTAMIE_EXPEND_SA,2011,78,POTTAWATTAMIE,19821176,3423608,10657102,8667977,10588920,2009121,5762974,0,3863904,7902467,72697249,6024404,0,78721653,0,17546767,96268420,POINT (-95.5423935 41.3366123)
2016_69_MONTGOMERY_EXPEND_SA,2016,69,MONTGOMERY,2857986,684895,343992,401097,3801658,474960,1891112,0,412988,130158,10998846,850000,0,11848846,0,4467543,16316389,POINT (-95.1563758 41.03014)
2018_35_FRANKLIN_EXPEND_SA,2018,35,FRANKLIN,1862411,2095058,375602,1389764,6001000,505001,2024801,0,2320823,980000,17554460,2460581,0,20015041,0,15530999,35546040,POINT (-93.262473 42.7325458)
2014_86_TAMA_EXPEND_SA,2014,86,TAMA,3556125,1490424,1413873,833137,7214657,523710,1405162,26250,199002,10029887,26692227,2027364,0,28719591,0,5250212,33969803,POINT (-92.5325425 42.07981170000001)
2011_95_WINNEBAGO_EXPEND_SA,2011,95,WINNEBAGO,1785808,914644,1348327,882111,3471755,436019,1017137,158768,1551647,13096145,24662361,1357060,0,26019421,0,4301863,30321284,POINT (-93.7341955 43.37756780000001)
2014_13_CALHOUN_EXPEND_SA,2014,13,CALHOUN,2245887,2082485,260150,808931,5123816,601377,1334434,5685,0,808000,13270765,1324434,0,14595199,0,8876182,23471381,POINT (-94.6404136 42.385184800000005)
2010_30_DICKINSON_EXPEND_SA,2010,30,DICKINSON,2263439,551988,1463815,1820458,3460600,581068,1861885,74200,1758693,1752000,15588146,2379581,0,17967727,0,6497089,24464816,POINT (-95.1508301 43.3779848)
2010_87_TAYLOR_EXPEND_SA,2010,87,TAYLOR,823344,1011035,648649,257963,2891000,303000,639959,0,200804,140000,6915754,677420,0,7593174,0,1243688,8836862,POINT (-94.6964148 40.73743240000001)
2010_1_ADAIR_EXPEND_SA,2010,1,ADAIR,985314,263246,954924,367743,3775903,272111,669816,0,0,1710000,8999057,1589688,0,10588745,0,1848694,12437439,POINT (-94.4709413 41.3307464)
2021_71_O'BRIEN_EXPEND_SA,2021,71,O'BRIEN,4266396,483517,738382,1201929,5361491,694456,1458059,12800,0,2598964,16815994,4275704,0,21091698,0,4933681,26025379,POINT (-95.6248784 43.0837527)
2019_27_DECATUR_EXPEND_SA,2019,27,DECATUR,1690166,707008,875456,538414,3470835,366325,883009,0,324964,61652,8917829,535355,0,9453184,0,2062674,11515858,POINT (-93.7862815 40.7376827)
2020_33_FAYETTE_EXPEND_SA,2020,33,FAYETTE,4188875,464553,919095,2007791,8528550,898778,1776390,29650,0,3055000,21868682,2416705,0,24285387,0,2816851,27102238,POINT (-91.8443207 42.8625919)
2012_67_MONONA_EXPEND_SA,2012,67,MONONA,1778450,739969,969700,648405,4615696,455533,1487312,0,49040,546828,11290933,1162623,0,12453556,0,3578369,16031925,POINT (-95.9599235 42.0516663)
2022_99_WRIGHT_EXPEND_SA,2022,99,WRIGHT,4544083,1145941,603876,1426986,6338499,672625,1894056,58862,3568088,1335000,21588016,2540151,0,24128167,0,3759643,27887810,POINT (-93.7351465 42.7331189)
2017_29_DES MOINES_EXPEND_SA,2017,29,DES MOINES,6752936,1666631,2008545,2080030,5549013,1097640,3261150,0,3514906,3660177,29591028,2074609,0,31665637,0,8119685,39785322,POINT (-91.1814707 40.9231829)
2014_1_ADAIR_EXPEND_SA,2014,1,ADAIR,1381399,322837,376637,526326,4343641,346533,814296,0,1053050,987000,10151719,1621247,0,11772966,0,3039490,14812456,POINT (-94.4709413 41.3307464)
2007_21_CLAY_EXPEND_SA,2007,21,CLAY,2276571,417625,1619758,872234,3699770,395086,1337466,16761,551855,1370000,12557126,1902816,,14459942,0,3764868,18224810,POINT (-95.1509194 43.0825804)
2016_38_GRUNDY_EXPEND_SA,2016,38,GRUNDY,1970774,566404,908889,976743,5132532,447016,1857463,0,1254043,3493836,16607700,1622669,0,18230369,0,3751911,21982280,POINT (-92.7914177 42.4018651)
2019_63_MARION_EXPEND_SA,2019,63,MARION,5136228,3621130,2994226,1970397,7333211,977334,3221735,0,465765,1815000,27535026,2464823,0,29999849,0,7523768,37523617,POINT (-93.0994367 41.3344515)
2006_6_BENTON_EXPEND_SA,2006,6,BENTON,2502463,720061,1856268,1317278,5399615,735445,1436748,0,178260,2068954,16215092,2803340,,19018432,0,3534966,22553398,POINT (-92.0656912 42.0801864)
2017_2_ADAMS_EXPEND_SA,2017,2,ADAMS,1208081,227966,153310,684835,3835000,343057,823154,42500,779952,305500,8403355,965883,0,9369238,0,1783476,11152714,POINT (-94.6991849 41.02898390000001)
2015_21_CLAY_EXPEND_SA,2015,21,CLAY,2929699,781793,1051797,1497667,5397768,434947,1759218,0,503197,1618900,15974986,2409294,0,18384280,0,5081521,23465801,POINT (-95.1509194 43.0825804)
2019_5_AUDUBON_EXPEND_SA,2019,5,AUDUBON,1639008,751238,158862,897111,4171808,416630,915978,100,371805,1477489,10800029,2239526,0,13039555,0,3146689,16186244,POINT (-94.9058222 41.6845893)
2020_91_WARREN_EXPEND_SA,2020,91,WARREN,6610870,2953369,1309215,1564210,10823750,1023780,3117996,0,2312004,21000000,50715194,3435000,0,54150194,0,15235741,69385935,POINT (-93.5613594 41.3343735)
2018_3_ALLAMAKEE_EXPEND_SA,2018,3,ALLAMAKEE,2446525,691599,866157,1201742,6253517,544678,1218334,19000,425000,2867084,16533636,1901128,0,18434764,0,2710875,21145639,POINT (-91.3780923 43.2842838)
2008_72_OSCEOLA_EXPEND_SA,2008,72,OSCEOLA,1001780,162260,633450,332940,2170000,234655,722352,0,303800,500000,6061237,895387,0,6956624,0,1917057,8873681,POINT (-95.6236852 43.3785704)
2013_53_JONES_EXPEND_SA,2013,53,JONES,2400433,776155,2633135,779294,6125807,638479,1546161,5900,7878,1660000,16573242,1583000,0,18156242,0,2346674,20502916,POINT (-91.1314352 42.1212397)
2019_68_MONROE_EXPEND_SA,2019,68,MONROE,2138368,848294,628213,559509,3152397,504257,1377130,0,561185,440000,10209353,1467912,0,11677265,0,2911209,14588474,POINT (-92.8689877 41.0297826)
2022_52_JOHNSON_EXPEND_SA,2022,52,JOHNSON,31199807,14784487,5872633,6823430,12378064,3389092,11961180,139600,22087648,18589551,127225492,16876839,0,144102331,0,25086765,169189096,POINT (-91.5880849 41.6715511)
2012_79_POWESHIEK_EXPEND_SA,2012,79,POWESHIEK,2826125,406876,1750862,570456,5186153,758041,1198050,162493,605628,760500,14225184,2056029,0,16281213,0,4065106,20346319,POINT (-92.53146840000001 41.6864422)
2016_20_CLARKE_EXPEND_SA,2016,20,CLARKE,1860555,962045,721731,319335,3486300,492347,1255727,0,237152,91228,9426420,635327,0,10061747,0,2947332,13009079,POINT (-93.78515790000002 41.0290323)
2017_89_VAN BUREN_EXPEND_SA,2017,89,VAN BUREN,1289300,488301,261380,352999,3421000,280057,666734,5600,0,1414500,8179871,703554,0,8883425,0,2775006,11658431,POINT (-91.9499871 40.7532294)
2021_7_BLACK HAWK_EXPEND_SA,2021,7,BLACK HAWK,23801689,7652234,4286247,3026440,8084469,2333571,6550534,0,5534689,5862878,67132751,12355097,0,79487848,0,33629608,113117456,POINT (-92.3088197 42.4700957)
2021_63_MARION_EXPEND_SA,2021,63,MARION,5261873,3259201,1387084,2022633,8492136,969735,4339144,0,370058,3675000,29776864,2772977,0,32549841,0,7636863,40186704,POINT (-93.0994367 41.3344515)
2018_40_HAMILTON_EXPEND_SA,2018,40,HAMILTON,3271129,1727677,1079979,1759466,5115300,562298,1615782,0,2386776,1242871,18761278,3020561,0,21781839,0,17804684,39586523,POINT (-93.7068085 42.3837722)
2010_94_WEBSTER_EXPEND_SA,2010,94,WEBSTER,5233864,2324635,5067562,1252211,6580000,858145,2673359,145000,574069,3230000,27938845,1950000,0,29888845,0,6115908,36004753,POINT (-94.18178810000002 42.4279662)
2017_66_MITCHELL_EXPEND_SA,2017,66,MITCHELL,1814881,1793772,582790,1695130,4380000,386084,1152506,0,4034484,370000,16209647,1290000,0,17499647,0,2302282,19801929,POINT (-92.7890315 43.3564124)
2012_7_BLACK HAWK_EXPEND_SA,2012,7,BLACK HAWK,17514067,8298399,6440122,8848451,6878699,1564010,5740975,0,5695928,6890427,67871078,2363170,0,70234248,0,13332152,83566400,POINT (-92.3088197 42.4700957)
2014_71_O'BRIEN_EXPEND_SA,2014,71,O'BRIEN,3165300,461081,1388600,847183,4480000,596314,1316557,9500,737021,790000,13791556,2112048,0,15903604,0,2864117,18767721,POINT (-95.6248784 43.0837527)
2013_22_CLAYTON_EXPEND_SA,2013,22,CLAYTON,2621238,738356,2168332,1356380,6762473,664221,1364895,1300,322439,3356675,19356309,1400000,0,20756309,0,5078187,25834496,POINT (-91.34143280000002 42.8447493)
2018_99_WRIGHT_EXPEND_SA,2018,99,WRIGHT,2876801,2910276,857238,1183049,5694800,568218,1598306,37680,485206,1273000,17484574,2123855,0,19608429,0,4064347,23672776,POINT (-93.7351465 42.7331189)
2022_39_GUTHRIE_EXPEND_SA,2022,39,GUTHRIE,2619188,1646248,296853,1849812,6693120,449665,1896616,14500,1815988,3227841,20509831,2824267,0,23334098,0,4910395,28244493,POINT (-94.501055 41.6837548)
2014_73_PAGE_EXPEND_SA,2014,73,PAGE,1868754,682239,1577174,531255,4030238,513547,1392607,4000,190468,558000,11348282,1180242,0,12528524,0,3248198,15776722,POINT (-95.1501747 40.7391444)
2010_23_CLINTON_EXPEND_SA,2010,23,CLINTON,6885668,1669584,8814018,1726034,4468225,1262439,3443525,523625,824864,2399814,32017796,745000,0,32762796,0,5270553,38033349,POINT (-90.5319724 41.8980358)
2008_23_CLINTON_EXPEND_SA,2008,23,CLINTON,6055553,1469316,8761730,1449650,4413765,1142879,2902638,42000,0,415196,26652727,654671,0,27307398,0,4865219,32172617,POINT (-90.5319724 41.8980358)
2019_91_WARREN_EXPEND_SA,2019,91,WARREN,6192700,2941474,1041050,1571731,6580311,979740,3065875,0,164731,2575000,25112612,3425000,0,28537612,0,10665551,39203163,POINT (-93.5613594 41.3343735)
2018_55_KOSSUTH_EXPEND_SA,2018,55,KOSSUTH,3263284,325044,798717,1096165,7408150,912311,2773492,84692,0,3290000,19951855,2863123,0,22814978,0,7412931,30227909,POINT (-94.2067199 43.20413)
2014_6_BENTON_EXPEND_SA,2014,6,BENTON,4220196,891350,1232400,2147213,6633000,764864,1573636,165000,99400,1802500,19529559,4000706,0,23530265,0,8398375,31928640,POINT (-92.0656912 42.0801864)
2012_56_LEE_EXPEND_SA,2012,56,LEE,4464576,3917301,5225287,1212158,4543983,1080846,2252765,0,813033,827835,24337784,1310000,0,25647784,0,5040411,30688195,POINT (-91.479264 40.6419764)
2021_91_WARREN_EXPEND_SA,2021,91,WARREN,7197760,2875336,1346315,1654920,9417800,1027745,3350810,0,3006110,26315000,56191796,3725000,0,59916796,0,10852448,70769244,POINT (-93.5613594 41.3343735)
2021_56_LEE_EXPEND_SA,2021,56,LEE,7252087,4742397,1623165,2219244,6907795,1431737,2539265,45840,866995,2138788,29767313,2540141,0,32307454,0,8956440,41263894,POINT (-91.479264 40.6419764)
2005_41_HANCOCK_EXPEND_SA,2005,41,HANCOCK,1166020,2597936,1411200,588144,3840000,294559,997640,2000,0,730000,11627499,1272143,,12899642,0,4680101,17579743,POINT (-93.7342723 43.0818861)
2008_8_BOONE_EXPEND_SA,2008,8,BOONE,2993617,741012,2540550,1158238,5196400,584576,1596505,0,732639,2626400,18169937,1889094,0,20059031,0,2510121,22569152,POINT (-93.931671 42.0365493)
2015_73_PAGE_EXPEND_SA,2015,73,PAGE,1882648,600082,1265531,537674,3870000,529801,1350308,4000,191748,389196,10620988,1218904,0,11839892,0,3699563,15539455,POINT (-95.1501747 40.7391444)
2005_27_DECATUR_EXPEND_SA,2005,27,DECATUR,723000,303438,1419561,403097,2695520,217046,471679,0,75000,268000,6576341,421498,,6997839,0,1441878,8439717,POINT (-93.7862815 40.7376827)
2020_24_CRAWFORD_EXPEND_SA,2020,24,CRAWFORD,2953762,2637731,609686,1126513,8496889,746613,1581799,0,153500,848503,19154996,3499400,0,22654396,0,6867354,29521750,POINT (-95.3819678 42.0372125)
2019_96_WINNESHIEK_EXPEND_SA,2019,96,WINNESHIEK,3514312,1382059,891531,2590684,7670000,648402,2755992,6500,0,2665000,22124480,2742101,0,24866581,0,8762015,33628596,POINT (-91.8437074 43.2906746)
2014_56_LEE_EXPEND_SA,2014,56,LEE,4570724,4624678,1923725,1349068,4928803,986538,2114498,20000,896622,10903288,32317944,1550000,0,33867944,0,6128010,39995954,POINT (-91.479264 40.6419764)
2016_13_CALHOUN_EXPEND_SA,2016,13,CALHOUN,2699399,1918370,434510,959719,5104300,649417,1316727,5225,0,1103000,14190667,1465156,0,15655823,0,6893146,22548969,POINT (-94.6404136 42.385184800000005)
2007_61_MADISON_EXPEND_SA,2007,61,MADISON,1835722,515737,1122440,518191,3551316,386128,847386,0,190878,1157077,10124875,893754,,11018629,0,1940581,12959210,POINT (-94.01556190000001 41.33071420000001)
2006_60_LYON_EXPEND_SA,2006,60,LYON,1999054,661943,838980,510938,3126640,484469,805941,14191,274175,823700,9540031,814000,,10354031,0,3205893,13559924,POINT (-96.2102924 43.380497)
2011_59_LUCAS_EXPEND_SA,2011,59,LUCAS,1004206,677014,1041531,198791,2932236,290690,993674,0,41900,1256000,8436042,749686,0,9185728,0,989068,10174796,POINT (-93.3277207 41.0293738)
2008_55_KOSSUTH_EXPEND_SA,2008,55,KOSSUTH,2514952,452397,1986753,757541,5705000,680046,1696851,67669,0,1508000,15369209,2092273,0,17461482,0,5130158,22591640,POINT (-94.2067199 43.20413)
2008_94_WEBSTER_EXPEND_SA,2008,94,WEBSTER,4775289,2453081,4542479,1180315,6200000,796220,2462269,605000,326913,3075721,26417287,1800000,0,28217287,0,8505790,36723077,POINT (-94.18178810000002 42.4279662)
2021_46_HUMBOLDT_EXPEND_SA,2021,46,HUMBOLDT,2582811,410222,372275,854678,4168969,509611,1441697,12500,127785,435000,10915548,2090185,0,13005733,0,4097857,17103590,POINT (-94.2071868 42.7764686)
2006_88_UNION_EXPEND_SA,2006,88,UNION,1182723,341453,1479139,358754,2220704,506502,788878,0,518324,284200,7680677,459647,,8140324,0,1823535,9963859,POINT (-94.2423792 41.0277304)
2022_63_MARION_EXPEND_SA,2022,63,MARION,5475826,3089282,1392525,2070368,8342966,1001669,4162628,0,748903,17215000,43499167,3016449,0,46515616,0,8833667,55349283,POINT (-93.0994367 41.3344515)
2005_56_LEE_EXPEND_SA,2005,56,LEE,3064250,3618671,4060196,1285148,3909414,919414,2212080,0,1464146,942225,21475544,1402000,,22877544,0,3561698,26439242,POINT (-91.479264 40.6419764)
2006_16_CEDAR_EXPEND_SA,2006,16,CEDAR,2424390,1280950,2786433,902590,4532977,562321,1353822,0,516915,1533000,15893398,2209646,,18103044,0,4720198,22823242,POINT (-91.1324125 41.7723207)
2011_39_GUTHRIE_EXPEND_SA,2011,39,GUTHRIE,1098249,1263657,1337515,1220198,3701457,361206,1026962,0,445000,1333000,11787244,1397972,0,13185216,0,1979947,15165163,POINT (-94.501055 41.6837548)
2009_6_BENTON_EXPEND_SA,2009,6,BENTON,3054497,784120,2146182,1584530,5957054,788808,1573694,0,0,1793783,17682668,3384380,0,21067048,0,5073314,26140362,POINT (-92.0656912 42.0801864)
2006_73_PAGE_EXPEND_SA,2006,73,PAGE,1330222,668949,1512888,240687,4008900,583200,777691,5000,29170,1661000,10817707,776565,,11594272,0,1850031,13444303,POINT (-95.1501747 40.7391444)
2006_41_HANCOCK_EXPEND_SA,2006,41,HANCOCK,1255311,2608527,1338400,504033,4712000,412835,1182272,2000,0,1620000,13635378,1521250,,15156628,0,6018677,21175305,POINT (-93.7342723 43.0818861)
2017_57_LINN_EXPEND_SA,2017,57,LINN,27809668,14930032,13315136,7641409,13717049,4234777,15366324,0,1917754,8685800,107617949,21614815,0,129232764,0,37775142,167007906,POINT (-91.5989646 42.0789478)
2020_39_GUTHRIE_EXPEND_SA,2020,39,GUTHRIE,2258271,1614284,315230,1757229,6370290,499045,1830880,23762,917328,520000,16106319,1988268,0,18094587,0,3628053,21722640,POINT (-94.501055 41.6837548)
2012_39_GUTHRIE_EXPEND_SA,2012,39,GUTHRIE,1056118,1202946,1240142,1178874,4073991,362948,973479,0,467100,513000,11068598,1375136,0,12443734,0,3107533,15551267,POINT (-94.501055 41.6837548)
2009_23_CLINTON_EXPEND_SA,2009,23,CLINTON,6166850,1647178,8707902,1623477,4775550,1442134,3241728,492000,0,461977,28558796,852750,0,29411546,0,4312678,33724224,POINT (-90.5319724 41.8980358)
2012_94_WEBSTER_EXPEND_SA,2012,94,WEBSTER,4953719,2715461,4936417,1246515,6530000,804875,2607702,200000,1038623,7600000,32633312,2913137,0,35546449,0,9831987,45378436,POINT (-94.18178810000002 42.4279662)
2012_89_VAN BUREN_EXPEND_SA,2012,89,VAN BUREN,1112890,1012917,666251,435864,2635000,308807,581657,1700,0,715200,7470286,624103,0,8094389,0,2579601,10673990,POINT (-91.9499871 40.7532294)
2005_24_CRAWFORD_EXPEND_SA,2005,24,CRAWFORD,1202963,1824681,1781559,752468,4708000,661810,1096107,0,0,1237000,13264588,1328122,,14592710,0,3866405,18459115,POINT (-95.3819678 42.0372125)
2015_6_BENTON_EXPEND_SA,2015,6,BENTON,4130394,954769,1922276,2174197,7228850,743853,1726086,160000,97775,2193794,21331994,4945555,0,26277549,0,9555205,35832754,POINT (-92.0656912 42.0801864)
2020_74_PALO ALTO_EXPEND_SA,2020,74,PALO ALTO,2308499,475081,385380,1493439,5319723,522745,1407120,0,2958983,764785,15635755,2827804,0,18463559,0,9440627,27904186,POINT (-94.6781371 43.0820643)
2005_9_BREMER_EXPEND_SA,2005,9,BREMER,1982551,562403,2008292,1385255,3268300,452765,1192514,0,54332,2406076,13312488,1764653,,15077141,0,7115051,22192192,POINT (-92.31805480000001 42.7745873)
2005_76_POCAHONTAS_EXPEND_SA,2005,76,POCAHONTAS,928080,1354390,1142000,501205,3139600,260119,968825,17535,0,1510500,9822254,608100,,10430354,0,5254705,15685059,POINT (-94.67874660000001 42.73413510000001)
2015_41_HANCOCK_EXPEND_SA,2015,41,HANCOCK,1609634,400588,554416,547303,5181300,442228,1159674,11200,0,560000,10466343,2245000,0,12711343,0,4033463,16744806,POINT (-93.7342723 43.0818861)
2020_7_BLACK HAWK_EXPEND_SA,2020,7,BLACK HAWK,22836137,7608726,5729038,4039539,7721074,2288409,6237904,0,6127904,2527553,65116284,10471171,0,75587455,0,25112450,100699905,POINT (-92.3088197 42.4700957)
2022_7_BLACK HAWK_EXPEND_SA,2022,7,BLACK HAWK,23655333,7734657,4084536,3084380,8136643,2374473,6544072,0,6109760,8235703,69959557,12416043,0,82375600,0,34475378,116850978,POINT (-92.3088197 42.4700957)
2010_74_PALO ALTO_EXPEND_SA,2010,74,PALO ALTO,1632477,386060,1611686,1521977,4013178,395025,1255542,0,1324512,7822370,19962827,1082812,0,21045639,0,7248212,28293851,POINT (-94.6781371 43.0820643)
2007_93_WAYNE_EXPEND_SA,2007,93,WAYNE,775405,657968,746880,297897,2167500,247548,692671,40750,25000,279200,5930819,461682,,6392501,0,1408080,7800581,POINT (-93.3273639 40.73947020000001)
2006_21_CLAY_EXPEND_SA,2006,21,CLAY,2108231,378239,1345563,778758,3787420,366397,1236640,16761,397233,2760500,13175742,1517816,,14693558,0,3144686,17838244,POINT (-95.1509194 43.0825804)
2005_59_LUCAS_EXPEND_SA,2005,59,LUCAS,845640,602692,1064815,217268,2517474,219819,755191,0,46311,1224000,7493210,507455,,8000665,0,599108,8599773,POINT (-93.3277207 41.0293738)
2014_24_CRAWFORD_EXPEND_SA,2014,24,CRAWFORD,2000741,2742302,619850,1040277,6532600,596178,1294638,0,244000,777852,15848438,2487502,0,18335940,0,6311026,24646966,POINT (-95.3819678 42.0372125)
2008_82_SCOTT_EXPEND_SA,2008,82,SCOTT,19265811,6051691,15508495,4045978,4286000,2036390,8731728,0,3481276,7409196,70816565,9395486,0,80212051,0,13711452,93923503,POINT (-90.6232428 41.6370978)
2007_38_GRUNDY_EXPEND_SA,2007,38,GRUNDY,1524123,480610,1416489,1200298,3426216,460807,1429699,0,104278,1432161,11474681,1141924,,12616605,0,4088779,16705384,POINT (-92.7914177 42.4018651)
2007_49_JACKSON_EXPEND_SA,2007,49,JACKSON,1456957,459498,2268784,987554,3578564,403630,1167294,144246,12689,1166810,11646026,1301500,,12947526,0,4040255,16987781,POINT (-90.5742294 42.1717426)
2009_38_GRUNDY_EXPEND_SA,2009,38,GRUNDY,1619580,487824,1342064,976927,3699663,400903,1506243,0,100288,868209,11001701,1198138,0,12199839,0,3784136,15983975,POINT (-92.7914177 42.4018651)
2010_16_CEDAR_EXPEND_SA,2010,16,CEDAR,2934250,1277391,2657214,1055633,4766440,508800,1419701,4656,0,1492000,16116085,1702857,0,17818942,0,3195841,21014783,POINT (-91.1324125 41.7723207)
2022_95_WINNEBAGO_EXPEND_SA,2022,95,WINNEBAGO,2900585,1708102,517737,1097793,4298770,767068,1465620,19000,1647104,2699651,17121430,3088883,0,20210313,0,9624119,29834432,POINT (-93.7341955 43.37756780000001)
2007_10_BUCHANAN_EXPEND_SA,2007,10,BUCHANAN,2598669,247375,2688088,872665,4551000,460435,1922126,37306,195251,932000,14504915,2026477,,16531392,0,2008030,18539422,POINT (-91.8378392 42.4707777)
2011_74_PALO ALTO_EXPEND_SA,2011,74,PALO ALTO,1640577,365590,1579333,1639145,4293018,392795,1211372,0,1314767,8207630,20644227,1226782,0,21871009,0,4048675,25919684,POINT (-94.6781371 43.0820643)
2018_8_BOONE_EXPEND_SA,2018,8,BOONE,3937067,753131,654450,1199235,6732600,715896,1956853,800000,473624,1510000,18732856,3151700,0,21884556,0,4417501,26302057,POINT (-93.931671 42.0365493)
2019_55_KOSSUTH_EXPEND_SA,2019,55,KOSSUTH,3401237,316547,630397,1139616,7736950,857608,2657805,85358,0,2915000,19740518,2865759,0,22606277,0,6983126,29589403,POINT (-94.2067199 43.20413)
2014_39_GUTHRIE_EXPEND_SA,2014,39,GUTHRIE,1208555,1319276,541314,1207050,4450595,397725,995469,0,0,940000,11059984,1477650,0,12537634,0,3799700,16337334,POINT (-94.501055 41.6837548)
2018_22_CLAYTON_EXPEND_SA,2018,22,CLAYTON,3015450,632986,722349,1304797,6223999,736047,1933698,1000,338777,2077600,16986703,1700000,0,18686703,0,6384954,25071657,POINT (-91.34143280000002 42.8447493)
2022_24_CRAWFORD_EXPEND_SA,2022,24,CRAWFORD,3083029,2711815,740429,1149309,8973034,739834,1703660,0,152880,902116,20156106,3867500,0,24023606,0,8362691,32386297,POINT (-95.3819678 42.0372125)
2017_6_BENTON_EXPEND_SA,2017,6,BENTON,4489356,1075457,1116550,1712058,7654401,782963,2015901,176000,183596,3070000,22276282,4285146,0,26561428,0,7551096,34112524,POINT (-92.0656912 42.0801864)
2015_88_UNION_EXPEND_SA,2015,88,UNION,1713383,634417,1238078,1581943,3593123,471029,1020500,0,1531117,199043,11982633,891441,0,12874074,0,2930402,15804476,POINT (-94.2423792 41.0277304)
2009_83_SHELBY_EXPEND_SA,2009,83,SHELBY,1759734,445239,2152894,418887,4235850,411627,1043694,0,326432,888196,11682553,2211486,0,13894039,0,3303364,17197403,POINT (-95.31021130000002 41.6850926)
2017_25_DALLAS_EXPEND_SA,2017,25,DALLAS,10973347,3459932,5788275,3417370,7758592,2272560,1567666,50500,2565973,3755000,41609215,6017986,0,47627201,0,22205350,69832551,POINT (-94.0397374 41.6848862)
2021_24_CRAWFORD_EXPEND_SA,2021,24,CRAWFORD,3058259,2621231,699260,1109606,8867073,718926,1613075,0,153100,1133927,19974457,3712500,0,23686957,0,7430397,31117354,POINT (-95.3819678 42.0372125)
2012_71_O'BRIEN_EXPEND_SA,2012,71,O'BRIEN,2856359,454731,1912250,844800,3948685,555049,964508,9700,492049,1260800,13298931,1554823,0,14853754,0,2923892,17777646,POINT (-95.6248784 43.0837527)
2007_75_PLYMOUTH_EXPEND_SA,2007,75,PLYMOUTH,2552207,265334,1808155,811898,5455500,671192,2505096,0,950254,1532157,16551793,2782956,,19334749,0,2643464,21978213,POINT (-96.2140431 42.7378346)
2008_87_TAYLOR_EXPEND_SA,2008,87,TAYLOR,754595,1016929,558016,214844,2517000,283422,606001,0,175001,625000,6750808,527820,0,7278628,0,1373586,8652214,POINT (-94.6964148 40.73743240000001)
2020_29_DES MOINES_EXPEND_SA,2020,29,DES MOINES,7911090,1831821,1546096,1567405,6757275,1091746,3346777,0,3543143,10312143,37907496,2371771,0,40279267,0,6851364,47130631,POINT (-91.1814707 40.9231829)
2014_9_BREMER_EXPEND_SA,2014,9,BREMER,3716365,548084,1452255,1297301,4430600,746972,1453313,86050,327330,1400000,15458270,2957085,0,18415355,0,8015800,26431155,POINT (-92.31805480000001 42.7745873)
2021_78_POTTAWATTAMIE_EXPEND_SA,2021,78,POTTAWATTAMIE,33498648,4421873,2378510,6835349,20886735,2554376,13696132,0,2645825,3687000,90604448,12625000,0,103229448,0,38058971,141288419,POINT (-95.5423935 41.3366123)
2013_41_HANCOCK_EXPEND_SA,2013,41,HANCOCK,1473614,1027423,1549000,518424,4824300,383853,951281,1700,0,567200,11296795,2065000,0,13361795,0,4643823,18005618,POINT (-93.7342723 43.0818861)
2011_91_WARREN_EXPEND_SA,2011,91,WARREN,4158007,2988026,3381838,1210111,6296824,794891,2623771,5000,25905,1628924,23113297,2321706,0,25435003,0,5902608,31337611,POINT (-93.5613594 41.3343735)
2008_50_JASPER_EXPEND_SA,2008,50,JASPER,4267460,1926178,5443341,1270508,6849225,885154,2639414,5100,1504180,2224921,27015481,3602341,0,30617822,0,3822587,34440409,POINT (-93.053765 41.6860394)
2018_23_CLINTON_EXPEND_SA,2018,23,CLINTON,8145363,1614931,2608936,1849375,6022074,1237702,4145736,920553,3229432,7205637,36979739,2116276,0,39096015,0,5872729,44968744,POINT (-90.5319724 41.8980358)
2010_55_KOSSUTH_EXPEND_SA,2010,55,KOSSUTH,2664902,452598,2351496,842347,6125000,721080,1865973,68376,107030,1585000,16783802,2855975,0,19639777,0,5508096,25147873,POINT (-94.2067199 43.20413)
2019_59_LUCAS_EXPEND_SA,2019,59,LUCAS,1246518,589983,338357,411761,4104622,342685,1341942,0,54596,1632681,10063145,708918,0,10772063,0,999113,11771176,POINT (-93.3277207 41.0293738)
2019_57_LINN_EXPEND_SA,2019,57,LINN,29556950,16271302,15559187,8034785,13724891,4919022,16451953,0,3566558,9895236,117979884,25890918,0,143870802,0,36527106,180397908,POINT (-91.5989646 42.0789478)
2010_42_HARDIN_EXPEND_SA,2010,42,HARDIN,3220495,322287,2172915,1162754,4780934,472073,1540243,78180,764495,1300400,15814776,2746995,0,18561771,0,5318308,23880079,POINT (-93.2404025 42.3838803)
2005_83_SHELBY_EXPEND_SA,2005,83,SHELBY,1437125,363628,1670796,340190,3994710,317732,932424,14185,56740,954265,10081795,1353334,,11435129,0,2393496,13828625,POINT (-95.31021130000002 41.6850926)
2015_56_LEE_EXPEND_SA,2015,56,LEE,4691935,4769174,2516336,1432295,4764765,980046,2236762,0,899417,15476738,37767468,1839775,0,39607243,0,6291418,45898661,POINT (-91.479264 40.6419764)
2012_24_CRAWFORD_EXPEND_SA,2012,24,CRAWFORD,1987140,2607434,2253471,903786,6345000,573389,1251437,0,246000,412000,16579657,2082500,0,18662157,0,5063543,23725700,POINT (-95.3819678 42.0372125)
2007_17_CERRO GORDO_EXPEND_SA,2007,17,CERRO GORDO,5715766,4624323,5535367,1502474,5082536,922174,2197043,80750,1594239,12050000,39304672,2360237,,41664909,0,7854923,49519832,POINT (-93.2608184 43.081557700000005)
2016_73_PAGE_EXPEND_SA,2016,73,PAGE,2741252,742246,743691,409562,4060000,543697,1353055,4000,323403,1000000,11920906,1230582,0,13151488,0,4975411,18126899,POINT (-95.1501747 40.7391444)
2021_31_DUBUQUE_EXPEND_SA,2021,31,DUBUQUE,16916356,5104150,3958761,5333493,10016526,2095457,4935746,1305000,2811286,7253100,59729875,5878042,0,65607917,0,26384346,91992263,POINT (-90.8824564 42.468832)
2013_9_BREMER_EXPEND_SA,2013,9,BREMER,3536198,487243,2431916,1294426,4289200,711395,1436507,83000,319743,1440000,16029628,2784954,0,18814582,0,8675516,27490098,POINT (-92.31805480000001 42.7745873)
2007_90_WAPELLO_EXPEND_SA,2007,90,WAPELLO,3483430,1610181,4208388,718452,3442100,566321,2505791,112275,180076,1174000,18001014,850000,,18851014,0,5742933,24593947,POINT (-92.4094499 41.03058450000001)
2016_28_DELAWARE_EXPEND_SA,2016,28,DELAWARE,2637728,599208,1696982,1007391,5775550,848508,1591248,41300,513910,3822874,18534699,2219826,0,20754525,0,4472465,25226990,POINT (-91.3673502 42.471211)
2016_45_HOWARD_EXPEND_SA,2016,45,HOWARD,1719914,566707,730449,1564263,4143824,450797,1143907,0,1561146,1573168,13454175,1681412,0,15135587,0,3980462,19116049,POINT (-92.3171989 43.3567673)
2006_53_JONES_EXPEND_SA,2006,53,JONES,1755086,764701,2293497,613744,4817835,620401,1261517,48622,0,2330000,14505403,962500,,15467903,0,2531379,17999282,POINT (-91.1314352 42.1212397)
2008_4_APPANOOSE_EXPEND_SA,2008,4,APPANOOSE,1768316,782704,1356894,679652,3060500,370123,785989,0,87190,578000,9469368,486360,0,9955728,0,2769733,12725461,POINT (-92.8686104 40.7431635)
2018_62_MAHASKA_EXPEND_SA,2018,62,MAHASKA,4039598,810642,1117757,982721,6497000,664732,1611012,100300,177011,4374642,20375415,3713254,0,24088669,0,6974990,31063659,POINT (-92.6409094 41.3352035)
2015_10_BUCHANAN_EXPEND_SA,2015,10,BUCHANAN,3406463,625709,1643897,1119325,6245250,737827,1594061,85889,416751,1439000,17314172,2346477,0,19660649,0,3794993,23455642,POINT (-91.8378392 42.4707777)
2011_27_DECATUR_EXPEND_SA,2011,27,DECATUR,952010,1241689,1175891,341646,2911482,275012,723985,0,0,247750,7869465,443376,0,8312841,0,1424132,9736973,POINT (-93.7862815 40.7376827)
2021_59_LUCAS_EXPEND_SA,2021,59,LUCAS,1352635,561716,344036,461491,4158670,372317,1380997,0,0,438000,9069862,782660,0,9852522,0,908489,10761011,POINT (-93.3277207 41.0293738)
2012_60_LYON_EXPEND_SA,2012,60,LYON,2877766,911950,1045157,793862,4499907,474852,1049351,85414,241623,812000,12791882,1612928,0,14404810,0,3470261,17875071,POINT (-96.2102924 43.380497)
2020_28_DELAWARE_EXPEND_SA,2020,28,DELAWARE,3248122,580649,1307872,1209245,6862123,1056813,2901769,49800,330000,2109000,19655393,2805810,0,22461203,0,10037543,32498746,POINT (-91.3673502 42.471211)
2022_92_WASHINGTON_EXPEND_SA,2022,92,WASHINGTON,8531082,2355345,974792,1359072,7494635,909285,2716042,18000,2742715,2131561,29232529,2860199,0,32092728,0,5510837,37603565,POINT (-91.7178676 41.335591)
2009_52_JOHNSON_EXPEND_SA,2009,52,JOHNSON,20132203,8444208,14144169,3143196,7359449,2421949,6726988,0,1969950,11517952,75860064,25871289,0,101731353,0,13101679,114833032,POINT (-91.5880849 41.6715511)
2008_19_CHICKASAW_EXPEND_SA,2008,19,CHICKASAW,1232392,1387739,1108136,650025,3495100,416728,1021456,0,0,929100,10240676,1936430,0,12177106,0,3563189,15740295,POINT (-92.3176637 43.06004140000001)
2022_43_HARRISON_EXPEND_SA,2022,43,HARRISON,3448141,1994394,323127,1350350,7200000,682729,1621696,0,633145,3316800,20570382,3274000,0,23844382,0,7217717,31062099,POINT (-95.8169209 41.6828528)
2017_93_WAYNE_EXPEND_SA,2017,93,WAYNE,1629601,1181118,340200,459119,3370450,266868,970497,25000,260743,1095000,9598596,525000,0,10123596,0,4631293,14754889,POINT (-93.3273639 40.73947020000001)
2020_94_WEBSTER_EXPEND_SA,2020,94,WEBSTER,5854528,4604476,1885333,2163330,9232300,1107877,3078242,70000,1783555,3385000,33164641,5893522,0,39058163,0,16821904,55880067,POINT (-94.18178810000002 42.4279662)
2021_95_WINNEBAGO_EXPEND_SA,2021,95,WINNEBAGO,2595559,1725760,437580,1068953,4043199,720656,1460426,18000,2465504,2733318,17268955,2255502,0,19524457,0,13306465,32830922,POINT (-93.7341955 43.37756780000001)
2009_37_GREENE_EXPEND_SA,2009,37,GREENE,1232214,351355,1401602,805466,3603670,354147,1247851,0,0,400000,9396305,1270000,0,10666305,0,2286705,12953010,POINT (-94.3968356 42.0362394)
2013_42_HARDIN_EXPEND_SA,2013,42,HARDIN,3576365,262300,1958192,889390,5118126,500751,1801416,232032,963087,3886800,19188459,2703448,0,21891907,0,7252396,29144303,POINT (-93.2404025 42.3838803)
2009_15_CASS_EXPEND_SA,2009,15,CASS,1985158,459673,2503840,565331,3888000,488218,1087605,1062015,0,5065043,17104883,5004486,0,22109369,0,1438433,23547802,POINT (-94.9278266 41.3314876)
2005_37_GREENE_EXPEND_SA,2005,37,GREENE,957763,294240,1253800,760728,3264500,277005,1087027,7500,0,285000,8187563,858000,,9045563,0,1773994,10819557,POINT (-94.3968356 42.0362394)
2014_77_POLK_EXPEND_SA,2014,77,POLK,65162843,34986183,28318446,11944883,9994353,7171815,30559746,0,15230188,19771737,223140194,13315476,0,236455670,0,56298177,292753847,POINT (-93.5735335 41.6855048)
2014_60_LYON_EXPEND_SA,2014,60,LYON,2931885,968529,556087,925594,4627990,486454,1082763,88930,243123,825000,12736355,2413849,0,15150204,0,5645323,20795527,POINT (-96.2102924 43.380497)
2016_9_BREMER_EXPEND_SA,2016,9,BREMER,3935415,1961890,1569673,1508544,4618800,745286,1699497,96426,321235,1375000,17831766,3006735,0,20838501,0,8480181,29318682,POINT (-92.31805480000001 42.7745873)
2006_70_MUSCATINE_EXPEND_SA,2006,70,MUSCATINE,5869052,1427767,4430733,772822,4323000,1136610,2183736,0,3332975,2920000,26396695,1256488,,27653183,0,4386346,32039529,POINT (-91.1127562 41.4839221)
2013_44_HENRY_EXPEND_SA,2013,44,HENRY,3287127,1000506,1123817,979310,4000000,616108,1221381,46800,238138,1901200,14414387,1106292,0,15520679,0,3727285,19247964,POINT (-91.5445241 40.9879383)
2007_65_MILLS_EXPEND_SA,2007,65,MILLS,2198250,1678542,1347118,1070765,4352300,416140,925991,0,0,500000,12489106,1350000,,13839106,0,2039778,15878884,POINT (-95.62132670000001 41.0334523)
2006_48_IOWA_EXPEND_SA,2006,48,IOWA,1989565,756082,1491397,711688,4365720,532915,1135148,21080,337481,2731033,14072109,824000,,14896109,0,2753854,17649963,POINT (-92.065524 41.6863229)
2017_42_HARDIN_EXPEND_SA,2017,42,HARDIN,4056641,302279,687629,1004132,6565884,599751,1922887,310829,2509414,595300,18554746,1910547,0,20465293,0,5279373,25744666,POINT (-93.2404025 42.3838803)
2005_31_DUBUQUE_EXPEND_SA,2005,31,DUBUQUE,9166209,7052974,13805635,2284474,6007380,1522548,2477077,107650,492200,2000000,44916147,4404233,,49320380,0,4598252,53918632,POINT (-90.8824564 42.468832)
2020_62_MAHASKA_EXPEND_SA,2020,62,MAHASKA,4471714,771872,1153955,1513353,7130698,711912,1539248,110000,804962,3852341,22060055,3668715,0,25728770,0,7507743,33236513,POINT (-92.6409094 41.3352035)
2019_10_BUCHANAN_EXPEND_SA,2019,10,BUCHANAN,3812331,665209,1362166,1221243,6789250,783306,1653719,63175,541841,975350,17867590,2706977,0,20574567,0,2873210,23447777,POINT (-91.8378392 42.4707777)
2005_52_JOHNSON_EXPEND_SA,2005,52,JOHNSON,12099098,6542329,9992350,2323939,6258731,1773380,5237127,1950,4032956,3627991,51889851,5841832,,57731683,0,8294017,66025700,POINT (-91.5880849 41.6715511)
2021_42_HARDIN_EXPEND_SA,2021,42,HARDIN,5629898,539954,943917,1160555,7123321,798142,2526096,388482,1905136,521400,21536901,2122717,0,23659618,0,5111999,28771617,POINT (-93.2404025 42.3838803)
2013_27_DECATUR_EXPEND_SA,2013,27,DECATUR,977859,1322754,1368966,389822,3266276,304731,682703,0,146000,269584,8728695,458000,0,9186695,0,2012224,11198919,POINT (-93.7862815 40.7376827)
2021_10_BUCHANAN_EXPEND_SA,2021,10,BUCHANAN,4185247,711547,1144988,1347969,7931500,873765,1853007,66375,936065,751900,19802363,2366412,0,22168775,0,3048487,25217262,POINT (-91.8378392 42.4707777)
2018_94_WEBSTER_EXPEND_SA,2018,94,WEBSTER,5599646,4187263,2453627,1989858,8940000,1051160,3094349,265000,1745786,4055900,33382589,5314538,0,38697127,0,14086759,52783886,POINT (-94.18178810000002 42.4279662)
2009_10_BUCHANAN_EXPEND_SA,2009,10,BUCHANAN,2307979,342684,2963889,1049112,5079900,527217,2064798,57725,453819,5646000,20493123,1755977,0,22249100,0,3484114,25733214,POINT (-91.8378392 42.4707777)
2013_63_MARION_EXPEND_SA,2013,63,MARION,3548413,2647073,2435330,1319040,5934532,797610,2346980,0,492874,665000,20186852,2253045,0,22439897,0,9960788,32400685,POINT (-93.0994367 41.3344515)
2006_92_WASHINGTON_EXPEND_SA,2006,92,WASHINGTON,2813922,2198725,1699500,528888,4574000,561796,1456060,62500,68253,1104100,15067744,1534534,,16602278,0,3014908,19617186,POINT (-91.7178676 41.335591)
2018_17_CERRO GORDO_EXPEND_SA,2018,17,CERRO GORDO,9303674,6011645,2922968,1698786,5886779,1289591,3731662,0,999844,3270000,35114949,7103824,0,42218773,0,12204093,54422866,POINT (-93.2608184 43.081557700000005)
2020_43_HARRISON_EXPEND_SA,2020,43,HARRISON,3119516,1919962,353400,1275070,6080000,647545,1613196,0,117725,2322000,17448414,2324600,0,19773014,0,8568481,28341495,POINT (-95.8169209 41.6828528)
2006_85_STORY_EXPEND_SA,2006,85,STORY,7948283,1966319,8617885,2498973,4405025,1798757,4527691,0,1203043,2192000,35157976,1838426,,36996402,0,6108466,43104868,POINT (-93.4650448 42.0362415)
2005_20_CLARKE_EXPEND_SA,2005,20,CLARKE,1307602,880473,897369,241806,2140100,309202,712539,0,607343,141800,7238234,523148,,7761382,0,3378505,11139887,POINT (-93.78515790000002 41.0290323)
2016_60_LYON_EXPEND_SA,2016,60,LYON,3224766,621272,571173,917657,5455620,517862,1249360,66404,243660,3662010,16529784,2567513,0,19097297,0,6047336,25144633,POINT (-96.2102924 43.380497)
2021_90_WAPELLO_EXPEND_SA,2021,90,WAPELLO,4956639,902372,1539643,1014941,4551763,752874,3178784,77110,486562,2472151,19932839,1200000,0,21132839,0,10065894,31198733,POINT (-92.4094499 41.03058450000001)
2009_27_DECATUR_EXPEND_SA,2009,27,DECATUR,947194,1376090,1271154,353646,3044255,272939,647160,0,0,196000,8108438,519314,0,8627752,0,1365249,9993001,POINT (-93.7862815 40.7376827)
2017_61_MADISON_EXPEND_SA,2017,61,MADISON,3024291,887408,382916,840836,5389143,570399,1059596,0,92315,1334997,13581901,1634781,0,15216682,0,2806798,18023480,POINT (-94.01556190000001 41.33071420000001)
2012_98_WORTH_EXPEND_SA,2012,98,WORTH,1975990,1172079,900027,878758,3642226,375961,1274068,0,1293005,8045000,19557114,1015094,0,20572208,0,5493820,26066028,POINT (-93.2608476 43.3773984)
2013_76_POCAHONTAS_EXPEND_SA,2013,76,POCAHONTAS,1720169,1475666,1025727,999929,4337344,354026,1348989,10385,0,1555000,12827235,1200000,0,14027235,0,51803,14079038,POINT (-94.67874660000001 42.73413510000001)
2022_75_PLYMOUTH_EXPEND_SA,2022,75,PLYMOUTH,4701109,479172,766616,1383625,9218000,962492,3705096,0,627670,3675000,25518780,4780000,0,30298780,0,10260245,40559025,POINT (-96.2140431 42.7378346)
2007_76_POCAHONTAS_EXPEND_SA,2007,76,POCAHONTAS,1168056,1458450,1155771,688377,3614500,291284,1034081,7485,0,2063000,11481004,650000,,12131004,0,2889783,15020787,POINT (-94.67874660000001 42.73413510000001)
2013_74_PALO ALTO_EXPEND_SA,2013,74,PALO ALTO,1766402,375820,1537835,1574067,4320660,422493,1250343,0,1184128,4296205,16727953,1328570,0,18056523,0,1499849,19556372,POINT (-94.6781371 43.0820643)
2019_95_WINNEBAGO_EXPEND_SA,2019,95,WINNEBAGO,2266123,1600926,933330,987062,3934520,638046,1400224,7770,2692654,2094489,16555144,1564727,0,18119871,0,19349649,37469520,POINT (-93.7341955 43.37756780000001)
2008_77_POLK_EXPEND_SA,2008,77,POLK,52623664,29845690,47041289,10585814,8945903,5978782,29808912,100000,10312376,34403865,229646295,14274426,0,243920721,0,48778960,292699681,POINT (-93.5735335 41.6855048)
2011_10_BUCHANAN_EXPEND_SA,2011,10,BUCHANAN,2902896,511135,3048366,1094200,5644000,667445,1437883,51489,383000,1542000,17282414,2072477,0,19354891,0,2970493,22325384,POINT (-91.8378392 42.4707777)
2012_43_HARRISON_EXPEND_SA,2012,43,HARRISON,2100547,1570525,2056300,869459,5455000,480642,1869859,0,448615,765830,15616777,1562076,0,17178853,0,6562009,23740862,POINT (-95.8169209 41.6828528)
2010_70_MUSCATINE_EXPEND_SA,2010,70,MUSCATINE,7294180,1534736,5325749,2554218,6500000,810997,2632821,30000,3995214,1225000,31902915,1352950,0,33255865,0,2722740,35978605,POINT (-91.1127562 41.4839221)
2008_9_BREMER_EXPEND_SA,2008,9,BREMER,2840597,595791,2079108,1759203,3455400,580342,1453781,0,795373,1000000,14559595,2769003,0,17328598,0,6558217,23886815,POINT (-92.31805480000001 42.7745873)
2019_51_JEFFERSON_EXPEND_SA,2019,51,JEFFERSON,3372416,903132,759293,797504,4193000,599671,1281532,0,377242,741155,13024945,1000000,0,14024945,0,3595362,17620307,POINT (-91.9488774 41.0317596)
2007_13_CALHOUN_EXPEND_SA,2007,13,CALHOUN,1323372,3597028,1134050,595763,3630145,405920,978600,7925,0,729000,12401803,1145694,,13547497,0,2874271,16421768,POINT (-94.6404136 42.385184800000005)
2008_30_DICKINSON_EXPEND_SA,2008,30,DICKINSON,2129920,550848,1344773,2224561,2936900,539935,1604069,390500,1450702,2969000,16141208,1962755,0,18103963,0,6707181,24811144,POINT (-95.1508301 43.3779848)
2006_9_BREMER_EXPEND_SA,2006,9,BREMER,2409774,515247,1700094,1291570,3363900,492140,1325441,0,712549,1587000,13397715,1998700,,15396415,0,5850927,21247342,POINT (-92.31805480000001 42.7745873)
2007_42_HARDIN_EXPEND_SA,2007,42,HARDIN,2999622,333062,1890294,762659,4009191,387512,1357158,95280,585113,897100,13316991,2855593,,16172584,0,4906329,21078913,POINT (-93.2404025 42.3838803)
2007_45_HOWARD_EXPEND_SA,2007,45,HOWARD,1023032,395851,1042178,1001259,2917826,261376,801737,1000,49939,594404,8088602,903006,,8991608,0,1806695,10798303,POINT (-92.3171989 43.3567673)
2005_5_AUDUBON_EXPEND_SA,2005,5,AUDUBON,835538,554569,768800,717785,2652966,255656,601104,1100,280730,158000,6826248,524093,,7350341,0,3192430,10542771,POINT (-94.9058222 41.6845893)
2007_97_WOODBURY_EXPEND_SA,2007,97,WOODBURY,11109842,4504209,10084845,2287570,6762831,2061227,6175879,511635,649936,2187660,46335634,4610711,,50946345,0,7194826,58141171,POINT (-96.0447673 42.3897169)
2006_28_DELAWARE_EXPEND_SA,2006,28,DELAWARE,1512282,450568,2077087,650140,4298000,583552,987399,17900,0,2023500,12600428,1363492,,13963920,0,1722598,15686518,POINT (-91.3673502 42.471211)
2014_28_DELAWARE_EXPEND_SA,2014,28,DELAWARE,2372568,681898,1550998,924126,5307385,788479,1467914,37900,73000,2044633,15248901,2014145,0,17263046,0,3482544,20745590,POINT (-91.3673502 42.471211)
2013_10_BUCHANAN_EXPEND_SA,2013,10,BUCHANAN,3031870,593860,3181744,1165177,6241250,710238,1417829,53375,500386,1982350,18878079,2332827,0,21210906,0,3011534,24222440,POINT (-91.8378392 42.4707777)
2006_38_GRUNDY_EXPEND_SA,2006,38,GRUNDY,1347474,481628,1360757,1259900,3288000,449413,1275236,0,156598,1771149,11390155,1002700,,12392855,0,4016978,16409833,POINT (-92.7914177 42.4018651)
2018_77_POLK_EXPEND_SA,2018,77,POLK,76357453,38855690,21215257,13949198,10991728,8059531,33882657,0,18721138,44697078,266729730,20084486,0,286814216,0,96555998,383370214,POINT (-93.5735335 41.6855048)
2018_28_DELAWARE_EXPEND_SA,2018,28,DELAWARE,3026958,549308,1515973,1020226,6563874,779674,2082318,49800,539634,2329965,18457730,2550011,0,21007741,0,6843039,27850780,POINT (-91.3673502 42.471211)
2008_45_HOWARD_EXPEND_SA,2008,45,HOWARD,1096287,424768,1073386,834020,2792421,283690,832663,1000,49940,39172,7427347,903365,0,8330712,0,2228833,10559545,POINT (-92.3171989 43.3567673)
2020_11_BUENA VISTA_EXPEND_SA,2020,11,BUENA VISTA,4687237,1680464,814908,1618517,6185000,939289,1980091,175600,1199968,1520125,20801199,2832396,0,23633595,0,4044134,27677729,POINT (-95.15114900000002 42.7354936)
2021_74_PALO ALTO_EXPEND_SA,2021,74,PALO ALTO,2345618,523969,288100,1717384,6099454,515461,1369475,0,2327755,388000,15575216,2758118,0,18333334,0,6193980,24527314,POINT (-94.6781371 43.0820643)
2010_12_BUTLER_EXPEND_SA,2010,12,BUTLER,1797567,1458006,1428870,742424,4310000,454196,1394393,10000,38942,1275000,12909398,1355000,0,14264398,0,4336699,18601097,POINT (-92.7901934 42.7315661)
2007_71_O'BRIEN_EXPEND_SA,2007,71,O'BRIEN,2586047,446937,1616104,545511,3300165,437693,841022,11000,303797,791000,10879276,1541777,,12421053,0,1866116,14287169,POINT (-95.6248784 43.0837527)
2008_62_MAHASKA_EXPEND_SA,2008,62,MAHASKA,2553182,933430,2386908,668039,4595000,565928,1273715,804550,8490,2385000,16174242,1406240,0,17580482,0,10602209,28182691,POINT (-92.6409094 41.3352035)
2005_80_RINGGOLD_EXPEND_SA,2005,80,RINGGOLD,629501,719392,860704,190547,2254278,235046,533591,16673,42681,330000,5812413,400000,,6212413,0,1703821,7916234,POINT (-94.2439719 40.7352023)
2013_16_CEDAR_EXPEND_SA,2013,16,CEDAR,3203311,1492396,2607861,1239465,5128000,481693,1478709,5100,0,908900,16545435,1866701,0,18412136,0,2166852,20578988,POINT (-91.1324125 41.7723207)
2006_97_WOODBURY_EXPEND_SA,2006,97,WOODBURY,10215170,4138291,9268819,1910306,6218044,2525040,5848821,50000,460704,2491311,43126506,4323015,,47449521,0,7509620,54959141,POINT (-96.0447673 42.3897169)
2009_42_HARDIN_EXPEND_SA,2009,42,HARDIN,3151136,331046,2033451,1205159,4316236,453701,1550868,89180,638251,1191386,14960414,2475358,0,17435772,0,4640983,22076755,POINT (-93.2404025 42.3838803)
2018_49_JACKSON_EXPEND_SA,2018,49,JACKSON,2422638,317139,1081251,1431157,5794905,708074,2008954,0,0,714358,14478476,1093200,0,15571676,0,7502309,23073985,POINT (-90.5742294 42.1717426)
2022_11_BUENA VISTA_EXPEND_SA,2022,11,BUENA VISTA,5342279,1698233,971963,1922082,6720000,1012270,2267705,317635,1403196,1881150,23536513,3003888,0,26540401,0,6324753,32865154,POINT (-95.15114900000002 42.7354936)
2020_77_POLK_EXPEND_SA,2020,77,POLK,80462942,41088538,27880386,14878791,11924833,8386804,37156993,0,21035645,45599549,288414481,28262533,0,316677014,0,96423160,413100174,POINT (-93.5735335 41.6855048)
2016_84_SIOUX_EXPEND_SA,2016,84,SIOUX,4558937,781744,1051847,1471496,6207175,999052,2351413,35000,887139,3738300,22082103,2986763,0,25068866,0,8840325,33909191,POINT (-96.1778827 43.0826174)
2014_7_BLACK HAWK_EXPEND_SA,2014,7,BLACK HAWK,18268452,8197698,7346351,3094069,5601325,1741161,5894660,0,5663255,3511251,59318222,2906004,0,62224226,0,16306994,78531220,POINT (-92.3088197 42.4700957)
2009_79_POWESHIEK_EXPEND_SA,2009,79,POWESHIEK,2276351,435823,1758520,876120,4402000,767187,1140798,213993,595588,7237367,19703747,1819646,0,21523393,0,4376171,25899564,POINT (-92.53146840000001 41.6864422)
2019_25_DALLAS_EXPEND_SA,2019,25,DALLAS,12361712,2380747,3031986,4826758,9296681,2153733,1986519,51850,4040282,21167427,61297695,6509915,0,67807610,0,21685534,89493144,POINT (-94.0397374 41.6848862)
2012_75_PLYMOUTH_EXPEND_SA,2012,75,PLYMOUTH,3061137,357557,1501235,948228,6306000,738520,4510669,0,1481950,878780,19784076,3128500,0,22912576,0,1821651,24734227,POINT (-96.2140431 42.7378346)
2015_67_MONONA_EXPEND_SA,2015,67,MONONA,1896972,555120,232614,753903,5270018,479478,1561966,0,46872,1237500,12034443,1624461,0,13658904,0,3694582,17353486,POINT (-95.9599235 42.0516663)
2011_71_O'BRIEN_EXPEND_SA,2011,71,O'BRIEN,2715035,445622,1912250,744128,3948700,508452,915999,8650,624948,989000,12812784,1307666,0,14120450,0,2519425,16639875,POINT (-95.6248784 43.0837527)
2015_44_HENRY_EXPEND_SA,2015,44,HENRY,3373734,996921,1746127,1148223,4379200,642257,1433801,58500,233500,811790,14824053,1343137,0,16167190,0,3823649,19990839,POINT (-91.5445241 40.9879383)
2018_2_ADAMS_EXPEND_SA,2018,2,ADAMS,1445389,223987,153310,722381,3598000,335425,853682,42500,775518,205500,8355692,981477,0,9337169,0,2525585,11862754,POINT (-94.6991849 41.02898390000001)
2022_28_DELAWARE_EXPEND_SA,2022,28,DELAWARE,3685801,652638,1255785,1256138,7604482,922032,2649370,52110,508400,1717000,20303756,2984599,0,23288355,0,11637635,34925990,POINT (-91.3673502 42.471211)
2009_5_AUDUBON_EXPEND_SA,2009,5,AUDUBON,1029110,618098,1144542,431047,3042456,308131,654989,100,112213,433265,7773951,635878,0,8409829,0,2167382,10577211,POINT (-94.9058222 41.6845893)
2017_10_BUCHANAN_EXPEND_SA,2017,10,BUCHANAN,3474703,636086,1216575,1157532,6187300,709157,1637691,90889,640297,1249900,17000130,2589477,0,19589607,0,6512519,26102126,POINT (-91.8378392 42.4707777)
2013_37_GREENE_EXPEND_SA,2013,37,GREENE,1388604,475488,1145013,817223,4076954,366185,1515300,50000,0,106000,9940767,1255000,0,11195767,0,3152096,14347863,POINT (-94.3968356 42.0362394)
2014_70_MUSCATINE_EXPEND_SA,2014,70,MUSCATINE,10061457,1319956,3129639,1084778,5847000,732568,3127044,0,1668000,2219000,29189442,1626500,0,30815942,0,5882686,36698628,POINT (-91.1127562 41.4839221)
2011_42_HARDIN_EXPEND_SA,2011,42,HARDIN,3380558,293213,2073584,1126199,4993380,472828,1477731,155680,822688,1395800,16191661,3142609,0,19334270,0,6142213,25476483,POINT (-93.2404025 42.3838803)
2019_88_UNION_EXPEND_SA,2019,88,UNION,1930185,552108,495156,626999,3769372,575592,1140325,0,1173300,2211442,12474479,980897,0,13455376,0,2599917,16055293,POINT (-94.2423792 41.0277304)
2010_38_GRUNDY_EXPEND_SA,2010,38,GRUNDY,1650862,458233,1363836,919193,4096770,404543,1514063,0,97913,1080718,11586131,1077600,0,12663731,0,3793451,16457182,POINT (-92.7914177 42.4018651)
2015_76_POCAHONTAS_EXPEND_SA,2015,76,POCAHONTAS,1948945,1500658,426955,1076802,4087043,377633,1482940,10385,90000,816002,11817363,1110000,0,12927363,0,4729010,17656373,POINT (-94.67874660000001 42.73413510000001)
2012_4_APPANOOSE_EXPEND_SA,2012,4,APPANOOSE,1994207,764896,1205659,744546,3162000,459857,1013286,0,197259,825000,10366710,776553,0,11143263,0,5906624,17049887,POINT (-92.8686104 40.7431635)
2012_28_DELAWARE_EXPEND_SA,2012,28,DELAWARE,2187063,683968,2727493,854194,4855556,691341,1362776,32400,72313,1676172,15143276,1935579,0,17078855,0,4129557,21208412,POINT (-91.3673502 42.471211)
2016_77_POLK_EXPEND_SA,2016,77,POLK,72112651,36196586,27670983,12503448,10098782,7622671,31560350,0,23037045,36286344,257088860,15119164,0,272208024,0,89252604,361460628,POINT (-93.5735335 41.6855048)
2014_65_MILLS_EXPEND_SA,2014,65,MILLS,3052269,1615784,361180,1476286,5330908,536011,1903517,0,524250,5650000,20450205,7528000,0,27978205,0,4483365,32461570,POINT (-95.62132670000001 41.0334523)
2018_60_LYON_EXPEND_SA,2018,60,LYON,3305114,641591,252121,918713,6683260,515091,1211793,90184,595555,6914900,21128322,3169192,0,24297514,0,4950918,29248432,POINT (-96.2102924 43.380497)
2021_27_DECATUR_EXPEND_SA,2021,27,DECATUR,1822354,769622,312344,637404,3860225,384226,939686,0,321282,178250,9225393,648712,0,9874105,0,2603529,12477634,POINT (-93.7862815 40.7376827)
2005_95_WINNEBAGO_EXPEND_SA,2005,95,WINNEBAGO,1077741,665965,1316309,689567,2734000,363022,722455,6630,197895,329166,8102750,1431809,,9534559,0,2054694,11589253,POINT (-93.7341955 43.37756780000001)
2013_5_AUDUBON_EXPEND_SA,2013,5,AUDUBON,1152034,616883,1043026,434204,3653566,372222,709003,0,77706,480000,8538644,755090,0,9293734,0,2185057,11478791,POINT (-94.9058222 41.6845893)
2007_86_TAMA_EXPEND_SA,2007,86,TAMA,2818982,1243900,1765549,1029428,5922666,514697,1250395,13000,0,3241432,17800049,1578170,,19378219,0,1813033,21191252,POINT (-92.5325425 42.07981170000001)
2013_95_WINNEBAGO_EXPEND_SA,2013,95,WINNEBAGO,1640093,1000062,1416842,900907,3217538,576309,995816,5000,936095,6001412,16690074,1518471,0,18208545,0,4356940,22565485,POINT (-93.7341955 43.37756780000001)
2022_60_LYON_EXPEND_SA,2022,60,LYON,3623149,671718,355132,990044,7485368,494527,1324596,119236,628800,2177000,17869570,3525452,0,21395022,0,6545972,27940994,POINT (-96.2102924 43.380497)
2014_38_GRUNDY_EXPEND_SA,2014,38,GRUNDY,1868998,536795,754926,900475,4424225,423752,1812569,0,1258320,971325,12951385,1527270,0,14478655,0,3381630,17860285,POINT (-92.7914177 42.4018651)
2009_20_CLARKE_EXPEND_SA,2009,20,CLARKE,1655988,1048723,1070600,283643,2417850,361865,796368,0,209400,295800,8140237,550909,0,8691146,0,2410967,11102113,POINT (-93.78515790000002 41.0290323)
2016_5_AUDUBON_EXPEND_SA,2016,5,AUDUBON,1433552,614926,232182,545129,3630125,347558,745215,100,748745,37284,8334816,857860,0,9192676,0,3773151,12965827,POINT (-94.9058222 41.6845893)
2008_99_WRIGHT_EXPEND_SA,2008,99,WRIGHT,1599013,3242648,1704738,1083627,3645000,450443,1038257,42500,208732,710000,13724958,1191953,0,14916911,0,2632563,17549474,POINT (-93.7351465 42.7331189)
2011_31_DUBUQUE_EXPEND_SA,2011,31,DUBUQUE,13394898,13422451,9537531,3513511,6599821,1371884,8216518,600,500900,4242000,60800114,4469944,0,65270058,0,5640128,70910186,POINT (-90.8824564 42.468832)
2013_48_IOWA_EXPEND_SA,2013,48,IOWA,3162702,1037926,1634095,983141,6120472,572284,1484292,72806,1256490,509623,16833831,1274698,0,18108529,0,4285093,22393622,POINT (-92.065524 41.6863229)
2012_36_FREMONT_EXPEND_SA,2012,36,FREMONT,1705316,312681,1237787,783890,3766000,400417,1277842,2300,146693,311000,9943926,908000,0,10851926,0,2977713,13829639,POINT (-95.6046765 40.7455892)
2012_48_IOWA_EXPEND_SA,2012,48,IOWA,2991472,997226,1552585,965098,5584889,534140,1344659,104185,1355914,674960,16105128,1271725,0,17376853,0,3649323,21026176,POINT (-92.065524 41.6863229)
2017_49_JACKSON_EXPEND_SA,2017,49,JACKSON,2345096,430496,954197,1438511,5597911,877575,1894667,0,0,826067,14364520,1035200,0,15399720,0,5662965,21062685,POINT (-90.5742294 42.1717426)
2014_97_WOODBURY_EXPEND_SA,2014,97,WOODBURY,13364338,5523285,5426606,2428067,7546993,2340117,6228742,271136,1057211,5882886,50069381,7774266,0,57843647,0,8351239,66194886,POINT (-96.0447673 42.3897169)
2018_66_MITCHELL_EXPEND_SA,2018,66,MITCHELL,1888575,1757301,628256,1450864,3825000,397859,1335249,0,4031389,3630000,18944493,1344160,0,20288653,0,3194362,23483015,POINT (-92.7890315 43.3564124)
2009_69_MONTGOMERY_EXPEND_SA,2009,69,MONTGOMERY,1634749,712711,1073169,306859,2757148,388374,765511,188,64496,412534,8115739,984202,0,9099941,0,2543617,11643558,POINT (-95.1563758 41.03014)
2008_36_FREMONT_EXPEND_SA,2008,36,FREMONT,1720542,181582,1438861,623552,3230000,377173,970356,2800,0,221000,8765866,834574,0,9600440,0,2436774,12037214,POINT (-95.6046765 40.7455892)
2016_41_HANCOCK_EXPEND_SA,2016,41,HANCOCK,1952787,351105,441962,586567,5270300,483446,1063020,14500,0,555000,10718687,2170000,0,12888687,0,4233736,17122423,POINT (-93.7342723 43.0818861)
2017_74_PALO ALTO_EXPEND_SA,2017,74,PALO ALTO,1958224,443075,466104,1370587,5001674,460821,1255069,0,1886621,3025290,15867465,2506136,0,18373601,0,6096618,24470219,POINT (-94.6781371 43.0820643)
2017_81_SAC_EXPEND_SA,2017,81,SAC,2680879,792277,326639,959850,5286650,499502,1447278,0,43076,1566500,13602651,1478267,0,15080918,0,3848328,18929246,POINT (-95.1053946 42.3862604)
2010_81_SAC_EXPEND_SA,2010,81,SAC,1986006,580653,1466000,821203,3694700,353329,1161618,0,55000,675000,10793509,1079071,0,11872580,0,1909806,13782386,POINT (-95.1053946 42.3862604)
2016_64_MARSHALL_EXPEND_SA,2016,64,MARSHALL,8022912,943564,1437317,930261,6080200,1069300,3271961,0,751500,1769345,24276360,2585000,0,26861360,0,6224058,33085418,POINT (-92.9987706 42.0358499)
2009_32_EMMET_EXPEND_SA,2009,32,EMMET,1493037,689794,1712721,428820,2776132,381371,974030,0,15300,267210,8738415,613084,0,9351499,0,866095,10217594,POINT (-94.6784803 43.37802250000001)
2020_48_IOWA_EXPEND_SA,2020,48,IOWA,5458880,1415754,1015000,1100599,7259150,763788,3394174,149060,770655,2395500,23722560,1315000,0,25037560,0,5845500,30883060,POINT (-92.065524 41.6863229)
2013_69_MONTGOMERY_EXPEND_SA,2013,69,MONTGOMERY,2054319,644685,1292605,358117,3255663,491278,1000812,200,410823,1599534,11108036,1115251,0,12223287,0,4358230,16581517,POINT (-95.1563758 41.03014)
2018_98_WORTH_EXPEND_SA,2018,98,WORTH,2281170,1038407,272277,944959,4024493,426023,1514128,0,2392263,1197000,14090720,1162398,0,15253118,0,7543434,22796552,POINT (-93.2608476 43.3773984)
2020_53_JONES_EXPEND_SA,2020,53,JONES,3184888,827546,889845,2094164,6881371,802949,1985227,92154,448584,4047599,21254327,2463664,0,23717991,0,4930998,28648989,POINT (-91.1314352 42.1212397)
2011_3_ALLAMAKEE_EXPEND_SA,2011,3,ALLAMAKEE,1461142,669814,1980979,971728,4535132,432794,872689,9350,0,1050000,11983628,1400961,0,13384589,0,2718512,16103101,POINT (-91.3780923 43.2842838)
2018_92_WASHINGTON_EXPEND_SA,2018,92,WASHINGTON,5297868,2346013,779757,1277037,6344032,769499,2304934,14000,2520455,1317136,22970731,2781656,0,25752387,0,2986703,28739090,POINT (-91.7178676 41.335591)
2020_98_WORTH_EXPEND_SA,2020,98,WORTH,2514043,1104984,279446,1006816,4396145,459062,1638581,0,2273061,1380000,15052138,1231732,0,16283870,0,7791680,24075550,POINT (-93.2608476 43.3773984)
2015_30_DICKINSON_EXPEND_SA,2015,30,DICKINSON,2496393,578572,887132,2719794,4388270,761354,2036133,178500,1721727,2179807,17947682,3130069,0,21077751,0,8316130,29393881,POINT (-95.1508301 43.3779848)
2010_34_FLOYD_EXPEND_SA,2010,34,FLOYD,2208720,1348887,2081547,737392,4713795,572934,1244656,0,185041,943000,14035972,986712,0,15022684,0,6011507,21034191,POINT (-92.78900330000002 43.0599208)
2011_51_JEFFERSON_EXPEND_SA,2011,51,JEFFERSON,2819088,737256,1252708,924121,2970000,500153,887253,0,183135,307500,10581214,994371,0,11575585,0,2967162,14542747,POINT (-91.9488774 41.0317596)
2020_66_MITCHELL_EXPEND_SA,2020,66,MITCHELL,2099961,1287513,579604,2243081,4160000,440861,1995302,0,4211459,960000,17977781,1412875,0,19390656,0,3360327,22750983,POINT (-92.7890315 43.3564124)
2018_71_O'BRIEN_EXPEND_SA,2018,71,O'BRIEN,3509431,434125,396966,930165,4537000,630936,1506535,13500,272458,2419000,14650116,2060650,0,16710766,0,6461568,23172334,POINT (-95.6248784 43.0837527)
2009_64_MARSHALL_EXPEND_SA,2009,64,MARSHALL,6194265,962635,3877775,958621,5711600,877065,2796653,0,739475,1626742,23744831,1512392,0,25257223,0,4819540,30076763,POINT (-92.9987706 42.0358499)
2014_18_CHEROKEE_EXPEND_SA,2014,18,CHEROKEE,2211255,387718,792630,927658,4366126,577668,1436746,0,0,1465000,12164801,1485000,0,13649801,0,4511029,18160830,POINT (-95.6238055 42.7356226)
2015_3_ALLAMAKEE_EXPEND_SA,2015,3,ALLAMAKEE,1818964,647397,964265,2640406,4937199,517532,1175749,213500,0,1550000,14465012,1644127,0,16109139,0,1953583,18062722,POINT (-91.3780923 43.2842838)
2020_16_CEDAR_EXPEND_SA,2020,16,CEDAR,4386836,1455712,783205,1623135,6818500,583928,1883632,7000,0,1175000,18716948,2684567,0,21401515,0,4437764,25839279,POINT (-91.1324125 41.7723207)
2012_31_DUBUQUE_EXPEND_SA,2012,31,DUBUQUE,13535431,13477777,9431810,3249526,6550373,1490372,3281697,800,523514,5373500,56914800,5263269,0,62178069,0,10854610,73032679,POINT (-90.8824564 42.468832)
2013_31_DUBUQUE_EXPEND_SA,2013,31,DUBUQUE,13766295,13684125,10916526,3518726,6545137,1366344,3469974,950,551956,6348936,60168969,6924821,0,67093790,0,11337575,78431365,POINT (-90.8824564 42.468832)
2006_33_FAYETTE_EXPEND_SA,2006,33,FAYETTE,2498455,556391,2526580,1243987,4339145,514480,1061712,8550,350705,1518864,14618869,1376149,,15995018,0,1059465,17054483,POINT (-91.8443207 42.8625919)
2005_48_IOWA_EXPEND_SA,2005,48,IOWA,1899004,719531,1483026,717398,4196181,345361,1064934,19840,81780,1524000,12051055,1147000,,13198055,0,2728427,15926482,POINT (-92.065524 41.6863229)
2005_16_CEDAR_EXPEND_SA,2005,16,CEDAR,2305241,1301404,2453206,855288,4464302,436403,1328559,0,520565,1000000,14664968,2211517,,16876485,0,5210071,22086556,POINT (-91.1324125 41.7723207)
2006_65_MILLS_EXPEND_SA,2006,65,MILLS,2170726,1656272,1337283,730944,4345900,542562,989662,0,0,500000,12273349,1172500,,13445849,0,2658524,16104373,POINT (-95.62132670000001 41.0334523)
2007_3_ALLAMAKEE_EXPEND_SA,2007,3,ALLAMAKEE,1205100,632767,1942826,745821,3540893,363218,886313,56420,0,500000,9873358,1109050,,10982408,0,2862788,13845196,POINT (-91.3780923 43.2842838)
2013_59_LUCAS_EXPEND_SA,2013,59,LUCAS,1016103,724653,1157908,186752,3195245,310512,927053,0,306256,1095200,8919682,582561,0,9502243,0,527774,10030017,POINT (-93.3277207 41.0293738)
2022_31_DUBUQUE_EXPEND_SA,2022,31,DUBUQUE,18163635,6336083,3606757,5184225,9733605,2323935,5731981,1190000,2813646,6183888,61267755,5149216,0,66416971,0,24581735,90998706,POINT (-90.8824564 42.468832)
2005_69_MONTGOMERY_EXPEND_SA,2005,69,MONTGOMERY,1454250,773509,894701,481879,2983920,370694,697922,93,113204,288570,8058742,892070,,8950812,0,1347115,10297927,POINT (-95.1563758 41.03014)
2021_14_CARROLL_EXPEND_SA,2021,14,CARROLL,4862100,1021610,754975,1234638,7017650,676701,2008237,55000,1156767,7759500,26547178,3981462,0,30528640,0,7127053,37655693,POINT (-94.8605593 42.0362382)
2014_92_WASHINGTON_EXPEND_SA,2014,92,WASHINGTON,4539054,2631192,677150,942693,5189114,706212,1949618,45400,3172840,3261606,23114879,2373465,0,25488344,0,3410462,28898806,POINT (-91.7178676 41.335591)
2005_63_MARION_EXPEND_SA,2005,63,MARION,2270188,2608780,2800610,1028300,5082041,531941,1901491,0,158965,1750200,18132516,1939613,,20072129,0,2336650,22408779,POINT (-93.0994367 41.3344515)
2019_46_HUMBOLDT_EXPEND_SA,2019,46,HUMBOLDT,2191949,409913,491536,809619,4036954,455234,1315654,0,131800,535000,10377659,1946980,0,12324639,0,2454784,14779423,POINT (-94.2071868 42.7764686)
2015_15_CASS_EXPEND_SA,2015,15,CASS,2911459,587154,1787045,537399,4688500,594745,1598711,1183695,161703,1983534,16033945,2330810,0,18364755,0,1823284,20188039,POINT (-94.9278266 41.3314876)
2006_80_RINGGOLD_EXPEND_SA,2006,80,RINGGOLD,710488,719873,845545,208055,2479338,230700,504767,16673,42680,210000,5968119,500000,,6468119,0,1506206,7974325,POINT (-94.2439719 40.7352023)
2018_13_CALHOUN_EXPEND_SA,2018,13,CALHOUN,3017650,1753614,454165,980498,5446800,608652,1356148,433625,0,1610500,15661652,1671581,0,17333233,0,7018712,24351945,POINT (-94.6404136 42.385184800000005)
2007_80_RINGGOLD_EXPEND_SA,2007,80,RINGGOLD,784886,726813,861315,224093,2446777,238889,513116,12500,42681,210000,6061070,480826,,6541896,0,646301,7188197,POINT (-94.2439719 40.7352023)
2011_98_WORTH_EXPEND_SA,2011,98,WORTH,1580875,1166312,900026,812877,2849485,351763,1309195,0,640336,1184714,10795583,938750,0,11734333,0,3952642,15686975,POINT (-93.2608476 43.3773984)
2009_47_IDA_EXPEND_SA,2009,47,IDA,718842,310085,704638,870976,2375000,267512,698669,0,0,750000,6695722,931049,0,7626771,0,1128602,8755373,POINT (-95.5134962 42.3868747)
2013_80_RINGGOLD_EXPEND_SA,2013,80,RINGGOLD,1050346,827117,748314,228517,2672941,222756,1508272,79540,300000,8000,7645803,619087,0,8264890,0,3271800,11536690,POINT (-94.2439719 40.7352023)
2020_21_CLAY_EXPEND_SA,2020,21,CLAY,3405196,808680,242550,1738797,6516606,640940,2760254,0,459135,1200000,17772158,3057787,0,20829945,0,6447275,27277220,POINT (-95.1509194 43.0825804)
2019_14_CARROLL_EXPEND_SA,2019,14,CARROLL,4012443,1154180,527305,1171104,6766350,663956,1815255,55000,18500,973100,17157193,3019551,0,20176744,0,5136431,25313175,POINT (-94.8605593 42.0362382)
2021_38_GRUNDY_EXPEND_SA,2021,38,GRUNDY,2266623,547535,370460,1193400,6381061,512886,1992853,0,1833878,3686180,18784876,3104262,0,21889138,0,3670566,25559704,POINT (-92.7914177 42.4018651)
2016_32_EMMET_EXPEND_SA,2016,32,EMMET,1826576,963705,704652,506583,3122532,485655,1396173,0,0,22002,9027878,985013,0,10012891,0,3292056,13304947,POINT (-94.6784803 43.37802250000001)
2010_7_BLACK HAWK_EXPEND_SA,2010,7,BLACK HAWK,16885278,12435323,23511215,7602549,5031050,1819234,6898448,0,4543868,8444535,87171500,2083911,0,89255411,0,15884478,105139889,POINT (-92.3088197 42.4700957)
2008_73_PAGE_EXPEND_SA,2008,73,PAGE,1525953,684948,1872079,284587,3815247,408274,859450,5000,107873,916400,10479811,721859,0,11201670,0,2449316,13650986,POINT (-95.1501747 40.7391444)
2011_14_CARROLL_EXPEND_SA,2011,14,CARROLL,2859045,1184304,2832130,1032189,4396160,449477,1505153,275000,83953,2729300,17346711,1383740,0,18730451,0,7690010,26420461,POINT (-94.8605593 42.0362382)
2005_91_WARREN_EXPEND_SA,2005,91,WARREN,3391055,2023687,2598656,744362,4240250,563348,1914028,0,437847,1827150,17740383,2195275,,19935658,0,3145200,23080858,POINT (-93.5613594 41.3343735)
2006_13_CALHOUN_EXPEND_SA,2006,13,CALHOUN,1280938,3573328,1097050,740098,3380145,384577,971256,7725,0,751000,12186117,1184440,,13370557,0,2695541,16066098,POINT (-94.6404136 42.385184800000005)
2018_45_HOWARD_EXPEND_SA,2018,45,HOWARD,1851183,450538,772137,2653757,4548666,463085,1242620,5000,1567780,1533202,15087968,1874443,0,16962411,0,4057622,21020033,POINT (-92.3171989 43.3567673)
2007_57_LINN_EXPEND_SA,2007,57,LINN,19938875,15234044,26747235,5490720,10467592,3447773,9292331,17854,1252505,1625000,93513929,9104074,,102618003,0,19144724,121762727,POINT (-91.5989646 42.0789478)
2007_30_DICKINSON_EXPEND_SA,2007,30,DICKINSON,1979239,504463,1314274,2416355,2990100,498089,1639031,287700,1513078,5498800,18641129,1754889,,20396018,0,5115771,25511789,POINT (-95.1508301 43.3779848)
2021_23_CLINTON_EXPEND_SA,2021,23,CLINTON,9671012,2166356,1520383,2087323,6434327,1326196,4290981,24000,1829531,3951000,33301109,2100765,0,35401874,0,15997751,51399625,POINT (-90.5319724 41.8980358)
2008_26_DAVIS_EXPEND_SA,2008,26,DAVIS,960358,321609,784160,273812,2785190,346698,862716,20000,0,286000,6640543,570194,0,7210737,0,1155888,8366625,POINT (-92.4097173 40.7476891)
2009_91_WARREN_EXPEND_SA,2009,91,WARREN,4132846,3057512,3402021,1014569,6258790,810995,2545511,0,516952,1737940,23477136,2099500,0,25576636,0,3842590,29419226,POINT (-93.5613594 41.3343735)
2013_12_BUTLER_EXPEND_SA,2013,12,BUTLER,2180685,1461569,14714795,853703,4850000,521234,1652063,2500,493785,1385000,28115334,2103181,0,30218515,0,6559366,36777881,POINT (-92.7901934 42.7315661)
2018_34_FLOYD_EXPEND_SA,2018,34,FLOYD,3161268,1330015,1184964,818802,5663050,680506,1337116,0,7208370,1005000,22389091,1305687,0,23694778,0,6096383,29791161,POINT (-92.78900330000002 43.0599208)
2008_41_HANCOCK_EXPEND_SA,2008,41,HANCOCK,1370589,3340835,1300000,548148,4299300,346116,1091387,6750,0,1367500,13670625,1680798,0,15351423,0,5842269,21193692,POINT (-93.7342723 43.0818861)
2006_24_CRAWFORD_EXPEND_SA,2006,24,CRAWFORD,1345109,1855555,1933689,769163,4634000,608718,1157702,0,0,1295000,13598936,1164500,,14763436,0,3930809,18694245,POINT (-95.3819678 42.0372125)
2021_70_MUSCATINE_EXPEND_SA,2021,70,MUSCATINE,12798217,1445469,1070608,2095443,7495000,970037,3658157,0,2476393,6909493,38918817,3047084,0,41965901,0,15929683,57895584,POINT (-91.1127562 41.4839221)
2009_74_PALO ALTO_EXPEND_SA,2009,74,PALO ALTO,1534569,404236,1612203,1592930,3898896,389536,1145890,0,1091295,6286140,17955695,1033469,0,18989164,0,13721823,32710987,POINT (-94.6781371 43.0820643)
2018_81_SAC_EXPEND_SA,2018,81,SAC,2736606,846491,327386,1077847,5318575,481519,1548693,0,0,1124500,13461617,1515699,0,14977316,0,3999552,18976868,POINT (-95.1053946 42.3862604)
2014_50_JASPER_EXPEND_SA,2014,50,JASPER,5434460,1884702,1724660,1425415,6775522,1115547,3133273,30500,2173675,2374047,26071801,5419127,0,31490928,0,5861087,37352015,POINT (-93.053765 41.6860394)
2008_58_LOUISA_EXPEND_SA,2008,58,LOUISA,1858436,636825,1197217,691776,2839780,266404,1282812,0,72560,898700,9744510,1197930,0,10942440,0,2004612,12947052,POINT (-91.2596184 41.2185073)
2005_84_SIOUX_EXPEND_SA,2005,84,SIOUX,3169510,1254826,2523204,633421,4425900,893121,1694188,50750,473816,2231175,17349911,2192786,,19542697,0,4357653,23900350,POINT (-96.1778827 43.0826174)
2014_45_HOWARD_EXPEND_SA,2014,45,HOWARD,1412948,789968,712679,1484245,3765779,437477,1063218,11000,899009,392714,10969037,1506581,0,12475618,0,3216684,15692302,POINT (-92.3171989 43.3567673)
2015_20_CLARKE_EXPEND_SA,2015,20,CLARKE,1731915,850208,540936,341851,2811150,548982,1091820,0,393348,120000,8430210,623959,0,9054169,0,2126680,11180849,POINT (-93.78515790000002 41.0290323)
2014_33_FAYETTE_EXPEND_SA,2014,33,FAYETTE,3210656,541933,1294972,1541149,5223530,740563,1422542,169600,0,628850,14773795,1801761,0,16575556,0,3033981,19609537,POINT (-91.8443207 42.8625919)
2022_55_KOSSUTH_EXPEND_SA,2022,55,KOSSUTH,4213081,394504,605202,1251244,9317400,1013178,2946199,57446,0,3778500,23576754,2975572,0,26552326,0,6244803,32797129,POINT (-94.2067199 43.20413)
2021_98_WORTH_EXPEND_SA,2021,98,WORTH,2593756,1109859,220860,1012164,4909274,467609,1747325,0,2278010,2955000,17293857,1284017,0,18577874,0,6505782,25083656,POINT (-93.2608476 43.3773984)
2016_96_WINNESHIEK_EXPEND_SA,2016,96,WINNESHIEK,2881765,1513761,1195238,1869560,6386750,594736,2237337,6000,0,5315000,22000147,2413993,0,24414140,0,5017573,29431713,POINT (-91.8437074 43.2906746)
2008_13_CALHOUN_EXPEND_SA,2008,13,CALHOUN,1297417,3823969,1479050,705523,3725645,432855,1042275,7425,0,784000,13298159,1149406,0,14447565,0,2462987,16910552,POINT (-94.6404136 42.385184800000005)
2019_78_POTTAWATTAMIE_EXPEND_SA,2019,78,POTTAWATTAMIE,31417624,3816584,2490981,6410612,14996790,2425421,7963431,0,3023908,9369000,81914351,7998500,0,89912851,0,31441482,121354333,POINT (-95.5423935 41.3366123)
2011_66_MITCHELL_EXPEND_SA,2011,66,MITCHELL,1345871,1920528,1005000,1370075,3395000,290094,1064197,0,768516,150000,11309281,1550372,0,12859653,0,1709911,14569564,POINT (-92.7890315 43.3564124)
2020_81_SAC_EXPEND_SA,2020,81,SAC,3086731,905150,301873,1123962,5361375,536786,1456696,1500,0,2393000,15167073,1592446,0,16759519,0,3353608,20113127,POINT (-95.1053946 42.3862604)
2010_49_JACKSON_EXPEND_SA,2010,49,JACKSON,1630830,483649,2371834,1037057,4419763,498289,1443045,121900,0,919400,12925767,1853889,0,14779656,0,3782665,18562321,POINT (-90.5742294 42.1717426)
2007_18_CHEROKEE_EXPEND_SA,2007,18,CHEROKEE,1614319,801485,1249754,468305,3326122,337893,1034337,0,0,1984000,10816215,1034000,,11850215,0,2162708,14012923,POINT (-95.6238055 42.7356226)
2020_6_BENTON_EXPEND_SA,2020,6,BENTON,5159491,1764081,1234232,6187485,8697824,829486,2369999,123000,0,2482500,28848098,4143516,0,32991614,0,4799387,37791001,POINT (-92.0656912 42.0801864)
2015_48_IOWA_EXPEND_SA,2015,48,IOWA,3451009,1102102,729235,1064713,6302000,712790,1528039,86600,843590,1170000,16990078,1315000,0,18305078,0,6512169,24817247,POINT (-92.065524 41.6863229)
2012_83_SHELBY_EXPEND_SA,2012,83,SHELBY,1938457,527785,2473265,412924,4274850,439109,1052456,0,131359,720000,11970205,2533637,0,14503842,0,2784558,17288400,POINT (-95.31021130000002 41.6850926)
2010_66_MITCHELL_EXPEND_SA,2010,66,MITCHELL,1564246,1147166,1667170,1186796,3700000,280780,1152566,0,604110,9050000,20352834,1301160,0,21653994,0,1774403,23428397,POINT (-92.7890315 43.3564124)
2019_31_DUBUQUE_EXPEND_SA,2019,31,DUBUQUE,15288646,5445581,3416208,3715194,9058172,1798689,4245135,1796951,4486610,23586554,72837740,5361392,0,78199132,0,20645709,98844841,POINT (-90.8824564 42.468832)
2011_46_HUMBOLDT_EXPEND_SA,2011,46,HUMBOLDT,1671357,389885,1398288,664307,3090799,387059,1021644,0,0,278000,8901339,1311908,0,10213247,0,3758631,13971878,POINT (-94.2071868 42.7764686)
2022_87_TAYLOR_EXPEND_SA,2022,87,TAYLOR,2174501,1510887,177000,436195,4595000,401473,1034868,0,963315,100000,11393239,957672,0,12350911,0,3935325,16286236,POINT (-94.6964148 40.73743240000001)
2012_63_MARION_EXPEND_SA,2012,63,MARION,3449520,2540541,2158904,1308636,6085067,876855,2226306,0,555914,635000,19836743,2037240,0,21873983,0,10299520,32173503,POINT (-93.0994367 41.3344515)
2011_83_SHELBY_EXPEND_SA,2011,83,SHELBY,1799907,528113,2305344,433207,4160000,406196,1054065,0,259203,996500,11942535,2545409,0,14487944,0,3538415,18026359,POINT (-95.31021130000002 41.6850926)
2009_96_WINNESHIEK_EXPEND_SA,2009,96,WINNESHIEK,2059724,1700647,2717370,1293028,4857741,346791,1515383,5000,487283,3886110,18869077,1862181,0,20731258,0,2709680,23440938,POINT (-91.8437074 43.2906746)
2015_99_WRIGHT_EXPEND_SA,2015,99,WRIGHT,2252537,4226878,976818,1158829,4708000,581793,1486978,33992,330591,850000,16606416,1767353,0,18373769,0,3985668,22359437,POINT (-93.7351465 42.7331189)
2017_17_CERRO GORDO_EXPEND_SA,2017,17,CERRO GORDO,9026814,5356824,2144386,1592152,6056231,1253573,3520992,0,1430276,2415000,32796248,6721071,0,39517319,0,12115377,51632696,POINT (-93.2608184 43.081557700000005)
2019_64_MARSHALL_EXPEND_SA,2019,64,MARSHALL,9187982,744983,1056570,1109016,7506000,1012260,2882766,0,118600,1060040,24678217,3580280,0,28258497,0,10823533,39082030,POINT (-92.9987706 42.0358499)
2007_25_DALLAS_EXPEND_SA,2007,25,DALLAS,5492889,2782200,3947225,2295099,5066866,1218215,2099961,51371,1445274,2492907,26892007,2317583,,29209590,0,10129984,39339574,POINT (-94.0397374 41.6848862)
2010_98_WORTH_EXPEND_SA,2010,98,WORTH,1578950,1164312,935425,800919,3305356,350684,1099626,0,700725,6271408,16207405,868013,0,17075418,0,2849758,19925176,POINT (-93.2608476 43.3773984)
2019_83_SHELBY_EXPEND_SA,2019,83,SHELBY,2564670,647973,271400,442593,6223936,440370,1256133,0,200100,796878,12844053,2901399,0,15745452,0,3360775,19106227,POINT (-95.31021130000002 41.6850926)
2010_2_ADAMS_EXPEND_SA,2010,2,ADAMS,991621,444074,496562,573328,2767500,219246,659932,42972,521315,26500,6743050,636606,0,7379656,0,1742251,9121907,POINT (-94.6991849 41.02898390000001)
2009_59_LUCAS_EXPEND_SA,2009,59,LUCAS,894339,634755,1108447,221041,2687293,309185,917979,0,103643,2246200,9122882,559874,0,9682756,0,619146,10301902,POINT (-93.3277207 41.0293738)
2015_80_RINGGOLD_EXPEND_SA,2015,80,RINGGOLD,1405404,857649,527328,267747,3013998,257084,824157,11000,193315,370000,7727682,723725,0,8451407,0,3313363,11764770,POINT (-94.2439719 40.7352023)
2008_68_MONROE_EXPEND_SA,2008,68,MONROE,1206189,823590,998831,654637,2219350,321235,980346,0,236391,934500,8375069,865062,0,9240131,0,940760,10180891,POINT (-92.8689877 41.0297826)
2012_16_CEDAR_EXPEND_SA,2012,16,CEDAR,3110809,1479828,2744922,1740291,4695000,482528,1479487,5914,0,277000,16015779,1831407,0,17847186,0,3081304,20928490,POINT (-91.1324125 41.7723207)
2007_35_FRANKLIN_EXPEND_SA,2007,35,FRANKLIN,1721427,1442116,1137544,650380,3558000,334161,1430629,0,408300,751000,11433557,1258000,,12691557,0,2800227,15491784,POINT (-93.262473 42.7325458)
2013_91_WARREN_EXPEND_SA,2013,91,WARREN,4496827,3282585,4539567,1233426,6471323,806396,2682522,17781,46350,434662,24011439,2900000,0,26911439,0,7808372,34719811,POINT (-93.5613594 41.3343735)
2006_2_ADAMS_EXPEND_SA,2006,2,ADAMS,747028,464039,485162,326758,2687000,315863,527707,43622,74923,290000,5962102,621870,,6583972,0,994270,7578242,POINT (-94.6991849 41.02898390000001)
2015_25_DALLAS_EXPEND_SA,2015,25,DALLAS,8982669,3131488,2352831,3120939,6732740,2360619,1571836,58000,1877958,3722980,33912060,5306831,0,39218891,0,14701213,53920104,POINT (-94.0397374 41.6848862)
2019_32_EMMET_EXPEND_SA,2019,32,EMMET,2128051,858764,487225,601458,3507270,537585,1468981,0,0,311230,9900564,1046210,0,10946774,0,4186630,15133404,POINT (-94.6784803 43.37802250000001)
2014_82_SCOTT_EXPEND_SA,2014,82,SCOTT,28443433,5994227,8511429,4691580,6133500,2356813,10718698,0,4377852,5224945,76452477,10771749,0,87224226,0,17872696,105096922,POINT (-90.6232428 41.6370978)
